;***************************************************************************************************
;        ARQUIVO DE MAPEAMENTO PARA O PADR√ÉO Memory
;***************************************************************************************************

;***************************************************************************************************
;Configura?o do NFSeDataset para Envio de Lote de RPS (Proxy)
;***************************************************************************************************
[ENVIAR]
XSDElementName=EnviarLoteRpsEnvio
XSDFile=nfse.xsd
XSDStartNode=
IgnoredXPaths=
UseNamespacePrefixes=0
XMLHeader=
RootAttributes=

;***************************************************************************************************
;Nomes dos comandos para os respectivos datasets (para uso nos arquivos TX2)
;***************************************************************************************************
[comandos]
EnviarLoteRpsEnvio.Insert=INCLUIR
EnviarLoteRpsEnvio.Post=SALVAR
Rps.Insert=INCLUIRRPS
Rps.Post=SALVARRPS

;***************************************************************************************************
;Nomes dos Campos: Envio de Lote de RPS (Proxy)
;***************************************************************************************************
[EnviarLoteRpsEnvio]
NumeroLote=EnviarLoteRpsEnvio/LoteRps/NumeroLote
Cnpj=EnviarLoteRpsEnvio/LoteRps/Cnpj
InscricaoMunicipal=EnviarLoteRpsEnvio/LoteRps/InscricaoMunicipal
QuantidadeRps=EnviarLoteRpsEnvio/LoteRps/QuantidadeRps
Versao=EnviarLoteRpsEnvio/LoteRps/@versao
IdCodigoMunicipio=EnviarLoteRpsEnvio/LoteRps/@codMunicipio
IdLote=EnviarLoteRpsEnvio/LoteRps/@Id
NumeroRps=EnviarLoteRpsEnvio/LoteRps/ListaRps/Rps/InfRps/IdentificacaoRps/Numero
SerieRps=EnviarLoteRpsEnvio/LoteRps/ListaRps/Rps/InfRps/IdentificacaoRps/Serie
TipoRps=EnviarLoteRpsEnvio/LoteRps/ListaRps/Rps/InfRps/IdentificacaoRps/Tipo
DataEmissao=EnviarLoteRpsEnvio/LoteRps/ListaRps/Rps/InfRps/DataEmissao
NaturezaOperacao=EnviarLoteRpsEnvio/LoteRps/ListaRps/Rps/InfRps/NaturezaOperacao
Status=EnviarLoteRpsEnvio/LoteRps/ListaRps/Rps/InfRps/Status
ValorServicos=EnviarLoteRpsEnvio/LoteRps/ListaRps/Rps/InfRps/Servico/Valores/ValorServicos
ValorDeducoes=EnviarLoteRpsEnvio/LoteRps/ListaRps/Rps/InfRps/Servico/Valores/ValorDeducoes
ValorPis=EnviarLoteRpsEnvio/LoteRps/ListaRps/Rps/InfRps/Servico/Valores/ValorPis
ValorCofins=EnviarLoteRpsEnvio/LoteRps/ListaRps/Rps/InfRps/Servico/Valores/ValorCofins
ValorInss=EnviarLoteRpsEnvio/LoteRps/ListaRps/Rps/InfRps/Servico/Valores/ValorInss
ValorIr=EnviarLoteRpsEnvio/LoteRps/ListaRps/Rps/InfRps/Servico/Valores/ValorIr
ValorCsll=EnviarLoteRpsEnvio/LoteRps/ListaRps/Rps/InfRps/Servico/Valores/ValorCsll
IssRetido=EnviarLoteRpsEnvio/LoteRps/ListaRps/Rps/InfRps/Servico/Valores/IssRetido
ValorIss=EnviarLoteRpsEnvio/LoteRps/ListaRps/Rps/InfRps/Servico/Valores/ValorIss
OutrasRetencoes=EnviarLoteRpsEnvio/LoteRps/ListaRps/Rps/InfRps/Servico/Valores/OutrasRetencoes
Aliquota=EnviarLoteRpsEnvio/LoteRps/ListaRps/Rps/InfRps/Servico/Valores/Aliquota
DescontoIncondicionado=EnviarLoteRpsEnvio/LoteRps/ListaRps/Rps/InfRps/Servico/Valores/DescontoIncondicionado
DescontoCondicionado=EnviarLoteRpsEnvio/LoteRps/ListaRps/Rps/InfRps/Servico/Valores/DescontoCondicionado
CodigoTributacaoMunicipio=EnviarLoteRpsEnvio/LoteRps/ListaRps/Rps/InfRps/Servico/CodigoTributacaoMunicipio
CodigoCnae=EnviarLoteRpsEnvio/LoteRps/ListaRps/Rps/InfRps/Servico/CodigoCnae
Discriminacao=EnviarLoteRpsEnvio/LoteRps/ListaRps/Rps/InfRps/Servico/Discriminacao
Observacoes=EnviarLoteRpsEnvio/LoteRps/ListaRps/Rps/InfRps/Servico/Observacoes
CodigoMunicipio=EnviarLoteRpsEnvio/LoteRps/ListaRps/Rps/InfRps/Servico/CodigoMunicipio
CnpjPrestador=EnviarLoteRpsEnvio/LoteRps/ListaRps/Rps/InfRps/Prestador/Cnpj
InscricaoMunicipalPrestador=EnviarLoteRpsEnvio/LoteRps/ListaRps/Rps/InfRps/Prestador/InscricaoMunicipal
InscricaoEstadualPrestador=EnviarLoteRpsEnvio/LoteRps/ListaRps/Rps/InfRps/Prestador/InscricaoEstadual
CnpjTomador=EnviarLoteRpsEnvio/LoteRps/ListaRps/Rps/InfRps/Tomador/IdentificacaoTomador/CpfCnpj/Cnpj
CpfTomador=EnviarLoteRpsEnvio/LoteRps/ListaRps/Rps/InfRps/Tomador/IdentificacaoTomador/CpfCnpj/Cpf
InscricaoMunicipalTomador=EnviarLoteRpsEnvio/LoteRps/ListaRps/Rps/InfRps/Tomador/IdentificacaoTomador/InscricaoMunicipal
InscricaoEstadualTomador=EnviarLoteRpsEnvio/LoteRps/ListaRps/Rps/InfRps/Tomador/IdentificacaoTomador/InscricaoEstadual
RazaoSocialTomador=EnviarLoteRpsEnvio/LoteRps/ListaRps/Rps/InfRps/Tomador/RazaoSocial
EnderecoTomador=EnviarLoteRpsEnvio/LoteRps/ListaRps/Rps/InfRps/Tomador/Endereco/Endereco
NumeroTomador=EnviarLoteRpsEnvio/LoteRps/ListaRps/Rps/InfRps/Tomador/Endereco/Numero
ComplementoTomador=EnviarLoteRpsEnvio/LoteRps/ListaRps/Rps/InfRps/Tomador/Endereco/Complemento
BairroTomador=EnviarLoteRpsEnvio/LoteRps/ListaRps/Rps/InfRps/Tomador/Endereco/Bairro
CodigoMunicipioTomador=EnviarLoteRpsEnvio/LoteRps/ListaRps/Rps/InfRps/Tomador/Endereco/CodigoMunicipio
UfTomador=EnviarLoteRpsEnvio/LoteRps/ListaRps/Rps/InfRps/Tomador/Endereco/Uf
CepTomador=EnviarLoteRpsEnvio/LoteRps/ListaRps/Rps/InfRps/Tomador/Endereco/Cep
EmailTomador=EnviarLoteRpsEnvio/LoteRps/ListaRps/Rps/InfRps/Tomador/Email
TelefoneTomador=EnviarLoteRpsEnvio/LoteRps/ListaRps/Rps/InfRps/Tomador/Telefone
RazaoSocialIntermediario=EnviarLoteRpsEnvio/LoteRps/ListaRps/Rps/InfRps/IntermediarioServico/RazaoSocial
CnpjIntermediario=EnviarLoteRpsEnvio/LoteRps/ListaRps/Rps/InfRps/IntermediarioServico/CpfCnpj/Cnpj
InscricaoMunicipalIntermediario=EnviarLoteRpsEnvio/LoteRps/ListaRps/Rps/InfRps/IntermediarioServico/InscricaoMunicipal
CodigoObra=EnviarLoteRpsEnvio/LoteRps/ListaRps/Rps/InfRps/ConstrucaoCivil/CodigoObra
Art=EnviarLoteRpsEnvio/LoteRps/ListaRps/Rps/InfRps/ConstrucaoCivil/Art
IdRPS=EnviarLoteRpsEnvio/LoteRps/ListaRps/Rps/InfRps/@Id

;***************************************************************************************************
;Defini?es dos Campos: Impress? de NFSe (Impress? Nova)
;***************************************************************************************************
[PrintXml_DadosNFSe]
FILE=MappingImpressaoNFSe.txt

;***************************************************************************************************
;Defini?es dos Campos: Impress? de RPS (Impress? Nova)
;***************************************************************************************************
[PrintXml_DadosRPS]
FILE=MappingImpressaoRPS.txt

;***************************************************************************************************
;Campos de Configura?o da Impress? Nova
;***************************************************************************************************
[PrintXml_Config]
ModoImpressao=String[4]
DiretorioTemplates=String[255]
Titulo=String[80]
BrasaoMunicipio=String[255]
LogotipoEmitente=String[255]
ArquivoMunicipios=String[255]
DebugMode=String[5]
NomeCidade=String[80]
NomePadrao=String[80]
