;***************************************************************************************************
;        ARQUIVO DE MAPEAMENTO PARA O PADRÃO RECIFE
;***************************************************************************************************

;***************************************************************************************************
;Configuração do NFSeDataset para Envio de Lote de RPS (Proxy)
;***************************************************************************************************
[ENVIAR]
XSDElementName=GerarNfseEnvio
XSDFile=tipos_nfse_v01.xsd
XSDStartNode=
IgnoredXPaths=GerarNfseEnvio/Rps/Signature
UseNamespacePrefixes=0
XMLHeader=
RootAttributes=
IgnoreUnknownElements=1

;***************************************************************************************************
;Nomes dos comandos para os respectivos datasets (para uso nos arquivos TX2)
;***************************************************************************************************
[comandos]
GerarNfseEnvio.Insert=INCLUIRITEM
GerarNfseEnvio.Post=SALVARITEM

;***************************************************************************************************
;Nomes dos Campos: Envio de Lote de RPS (Proxy)
;***************************************************************************************************
[GerarNfseEnvio]
NumeroRps=GerarNfseEnvio/Rps/InfRps/IdentificacaoRps/Numero
SerieRps=GerarNfseEnvio/Rps/InfRps/IdentificacaoRps/Serie
TipoRps=GerarNfseEnvio/Rps/InfRps/IdentificacaoRps/Tipo
DataEmissao=GerarNfseEnvio/Rps/InfRps/DataEmissao
NaturezaOperacao=GerarNfseEnvio/Rps/InfRps/NaturezaOperacao
RegimeEspecialTributacao=GerarNfseEnvio/Rps/InfRps/RegimeEspecialTributacao
OptanteSimplesNacional=GerarNfseEnvio/Rps/InfRps/OptanteSimplesNacional
IncentivadorCultural=GerarNfseEnvio/Rps/InfRps/IncentivadorCultural
Status=GerarNfseEnvio/Rps/InfRps/Status
NumeroRpsSubstituido=GerarNfseEnvio/Rps/InfRps/RpsSubstituido/Numero
SerieRpsSubstituido=GerarNfseEnvio/Rps/InfRps/RpsSubstituido/Serie
TipoRpsSubstituido=GerarNfseEnvio/Rps/InfRps/RpsSubstituido/Tipo
ValorServicos=GerarNfseEnvio/Rps/InfRps/Servico/Valores/ValorServicos
ValorDeducoes=GerarNfseEnvio/Rps/InfRps/Servico/Valores/ValorDeducoes
ValorPis=GerarNfseEnvio/Rps/InfRps/Servico/Valores/ValorPis
ValorCofins=GerarNfseEnvio/Rps/InfRps/Servico/Valores/ValorCofins
ValorInss=GerarNfseEnvio/Rps/InfRps/Servico/Valores/ValorInss
ValorIr=GerarNfseEnvio/Rps/InfRps/Servico/Valores/ValorIr
ValorCsll=GerarNfseEnvio/Rps/InfRps/Servico/Valores/ValorCsll
IssRetido=GerarNfseEnvio/Rps/InfRps/Servico/Valores/IssRetido
ValorIss=GerarNfseEnvio/Rps/InfRps/Servico/Valores/ValorIss
ValorIssRetido=GerarNfseEnvio/Rps/InfRps/Servico/Valores/ValorIssRetido
OutrasRetencoes=GerarNfseEnvio/Rps/InfRps/Servico/Valores/OutrasRetencoes
BaseCalculo=GerarNfseEnvio/Rps/InfRps/Servico/Valores/BaseCalculo
Aliquota=GerarNfseEnvio/Rps/InfRps/Servico/Valores/Aliquota
ValorLiquidoNfse=GerarNfseEnvio/Rps/InfRps/Servico/Valores/ValorLiquidoNfse
DescontoIncondicionado=GerarNfseEnvio/Rps/InfRps/Servico/Valores/DescontoIncondicionado
DescontoCondicionado=GerarNfseEnvio/Rps/InfRps/Servico/Valores/DescontoCondicionado
ItemListaServico=GerarNfseEnvio/Rps/InfRps/Servico/ItemListaServico
CodigoCnae=GerarNfseEnvio/Rps/InfRps/Servico/CodigoCnae
CodigoTributacaoMunicipio=GerarNfseEnvio/Rps/InfRps/Servico/CodigoTributacaoMunicipio
Discriminacao=GerarNfseEnvio/Rps/InfRps/Servico/Discriminacao
CodigoMunicipio=GerarNfseEnvio/Rps/InfRps/Servico/CodigoMunicipio
CnpjPrestador=GerarNfseEnvio/Rps/InfRps/Prestador/Cnpj
InscricaoMunicipalPrestador=GerarNfseEnvio/Rps/InfRps/Prestador/InscricaoMunicipal
CpfTomador=GerarNfseEnvio/Rps/InfRps/Tomador/IdentificacaoTomador/CpfCnpj/Cpf
CnpjTomador=GerarNfseEnvio/Rps/InfRps/Tomador/IdentificacaoTomador/CpfCnpj/Cnpj
InscricaoMunicipalTomador=GerarNfseEnvio/Rps/InfRps/Tomador/IdentificacaoTomador/InscricaoMunicipal
RazaoSocialTomador=GerarNfseEnvio/Rps/InfRps/Tomador/RazaoSocial
EnderecoTomador=GerarNfseEnvio/Rps/InfRps/Tomador/Endereco/Endereco
NumeroTomador=GerarNfseEnvio/Rps/InfRps/Tomador/Endereco/Numero
ComplementoTomador=GerarNfseEnvio/Rps/InfRps/Tomador/Endereco/Complemento
BairroTomador=GerarNfseEnvio/Rps/InfRps/Tomador/Endereco/Bairro
CodigoMunicipioTomador=GerarNfseEnvio/Rps/InfRps/Tomador/Endereco/CodigoMunicipio
UfTomador=GerarNfseEnvio/Rps/InfRps/Tomador/Endereco/Uf
CepTomador=GerarNfseEnvio/Rps/InfRps/Tomador/Endereco/Cep
TelefoneTomador=GerarNfseEnvio/Rps/InfRps/Tomador/Contato/Telefone
EmailTomador=GerarNfseEnvio/Rps/InfRps/Tomador/Contato/Email
RazaoSocialIntermediario=GerarNfseEnvio/Rps/InfRps/IntermediarioServico/RazaoSocial
CpfIntermediario=GerarNfseEnvio/Rps/InfRps/IntermediarioServico/CpfCnpj/Cpf
CnpjIntermediario=GerarNfseEnvio/Rps/InfRps/IntermediarioServico/CpfCnpj/Cnpj
InscricaoMunicipalIntermediario=GerarNfseEnvio/Rps/InfRps/IntermediarioServico/InscricaoMunicipal
CodigoObra=GerarNfseEnvio/Rps/InfRps/ConstrucaoCivil/CodigoObra
Art=GerarNfseEnvio/Rps/InfRps/ConstrucaoCivil/Art
IdRps=GerarNfseEnvio/Rps/InfRps/@Id

;***************************************************************************************************
;Definições dos Campos: Impressão de NFSe (Impressão Nova)
;***************************************************************************************************
[PrintXml_DadosNFSe]
FILE=MappingImpressao.txt

;***************************************************************************************************
;Definições dos Campos: Impressão de RPS (Impressão Nova)
;***************************************************************************************************
[PrintXml_DadosRPS]
FILE=MappingImpressao.txt

;***************************************************************************************************
;Campos de Configuração da Impressão Nova
;***************************************************************************************************
[PrintXml_Config]
ModoImpressao=String[4]
DiretorioTemplates=String[255]
Titulo=String[80]
BrasaoMunicipio=String[255]
LogotipoEmitente=String[255]
ArquivoMunicipios=String[255]
DebugMode=String[5]
NomeCidade=String[80]
NomePadrao=String[80]
