;***************************************************************************************************
;        ARQUIVO DE MAPEAMENTO PARA O PADRÃO EL
;***************************************************************************************************

;***************************************************************************************************
;Configuração do NFSeDataset para Envio de Lote de RPS (Proxy)
;***************************************************************************************************
[ENVIAR]
XSDElementName=LoteRps
XSDFile=el-nfse.xsd
XSDStartNode=
IgnoredXPaths=LoteRps/ListaRps/Rps/Signature
UseNamespacePrefixes=0
XMLHeader=
RootAttributes=

;***************************************************************************************************
;Nomes dos comandos para os respectivos datasets (para uso nos arquivos TX2)
;***************************************************************************************************
[comandos]
LoteRps.Insert=INCLUIR
LoteRps.Post=SALVAR
Rps.Insert=INCLUIRRPS
Rps.Post=SALVARRPS
Servico.Insert=INCLUIRSERVICO
Servico.Post=SALVARSERVICO

;***************************************************************************************************
;Nomes dos Campos: Envio de Lote de RPS (Proxy)
;***************************************************************************************************
[LoteRps]
IdLote=LoteRps/Id
NumeroLote=LoteRps/NumeroLote
QuantidadeRps=LoteRps/QuantidadeRps
CpfCnpjRemetente=LoteRps/IdentificacaoPrestador/CpfCnpj
IndicacaoCpfCnpjRemente=LoteRps/IdentificacaoPrestador/IndicacaoCpfCnpj
InscricaoMunicipalRemente=LoteRps/IdentificacaoPrestador/InscricaoMunicipal
IdRps=LoteRps/ListaRps/Rps/Id
LocalPrestacao=LoteRps/ListaRps/Rps/LocalPrestacao
IssRetido=LoteRps/ListaRps/Rps/IssRetido
DataEmissao=LoteRps/ListaRps/Rps/DataEmissao
NumeroRps=LoteRps/ListaRps/Rps/IdentificacaoRps/Numero
Serie=LoteRps/ListaRps/Rps/IdentificacaoRps/Serie
Tipo=LoteRps/ListaRps/Rps/IdentificacaoRps/Tipo
CpfCnpjPrestador=LoteRps/ListaRps/Rps/DadosPrestador/IdentificacaoPrestador/CpfCnpj
IndicacaoCpfCnpjPrestador=LoteRps/ListaRps/Rps/DadosPrestador/IdentificacaoPrestador/IndicacaoCpfCnpj
InscricaoMunicipalPrestador=LoteRps/ListaRps/Rps/DadosPrestador/IdentificacaoPrestador/InscricaoMunicipal
RazaoSocialPrestador=LoteRps/ListaRps/Rps/DadosPrestador/RazaoSocial
NomeFantasiaPrestador=LoteRps/ListaRps/Rps/DadosPrestador/NomeFantasia
IncentivadorCultural=LoteRps/ListaRps/Rps/DadosPrestador/IncentivadorCultural
OptanteSimplesNacional=LoteRps/ListaRps/Rps/DadosPrestador/OptanteSimplesNacional
NaturezaOperacao=LoteRps/ListaRps/Rps/DadosPrestador/NaturezaOperacao
RegimeEspecialTributacao=LoteRps/ListaRps/Rps/DadosPrestador/RegimeEspecialTributacao
LogradouroTipoPrestador=LoteRps/ListaRps/Rps/DadosPrestador/Endereco/LogradouroTipo
LogradouroPrestador=LoteRps/ListaRps/Rps/DadosPrestador/Endereco/Logradouro
LogradouroNumeroPrestador=LoteRps/ListaRps/Rps/DadosPrestador/Endereco/LogradouroNumero
LogradouroComplementoPrestador=LoteRps/ListaRps/Rps/DadosPrestador/Endereco/LogradouroComplemento
BairroPrestador=LoteRps/ListaRps/Rps/DadosPrestador/Endereco/Bairro
CodigoMunicipioPrestador=LoteRps/ListaRps/Rps/DadosPrestador/Endereco/CodigoMunicipio
MunicipioPrestador=LoteRps/ListaRps/Rps/DadosPrestador/Endereco/Municipio
UfPrestador=LoteRps/ListaRps/Rps/DadosPrestador/Endereco/Uf
CepPrestador=LoteRps/ListaRps/Rps/DadosPrestador/Endereco/Cep
TelefonePrestador=LoteRps/ListaRps/Rps/DadosPrestador/Contato/Telefone
EmailPrestador=LoteRps/ListaRps/Rps/DadosPrestador/Contato/Email
CpfCnpjTomador=LoteRps/ListaRps/Rps/DadosTomador/IdentificacaoTomador/CpfCnpj
IndicacaoCpfCnpjTomador=LoteRps/ListaRps/Rps/DadosTomador/IdentificacaoTomador/IndicacaoCpfCnpj
InscricaoMunicipalTomador=LoteRps/ListaRps/Rps/DadosTomador/IdentificacaoTomador/InscricaoMunicipal
InscricaoEstadualTomador=LoteRps/ListaRps/Rps/DadosTomador/IdentificacaoTomador/InscricaoEstadual
RazaoSocialTomador=LoteRps/ListaRps/Rps/DadosTomador/RazaoSocial
NomeFantasiaTomador=LoteRps/ListaRps/Rps/DadosTomador/NomeFantasia
LogradouroTipoTomador=LoteRps/ListaRps/Rps/DadosTomador/Endereco/LogradouroTipo
LogradouroTomador=LoteRps/ListaRps/Rps/DadosTomador/Endereco/Logradouro
LogradouroNumeroTomador=LoteRps/ListaRps/Rps/DadosTomador/Endereco/LogradouroNumero
LogradouroComplementoTomador=LoteRps/ListaRps/Rps/DadosTomador/Endereco/LogradouroComplemento
BairroTomador=LoteRps/ListaRps/Rps/DadosTomador/Endereco/Bairro
CodigoMunicipioTomador=LoteRps/ListaRps/Rps/DadosTomador/Endereco/CodigoMunicipio
MunicipioTomador=LoteRps/ListaRps/Rps/DadosTomador/Endereco/Municipio
UfTomador=LoteRps/ListaRps/Rps/DadosTomador/Endereco/Uf
CepTomador=LoteRps/ListaRps/Rps/DadosTomador/Endereco/Cep
TelefoneTomador=LoteRps/ListaRps/Rps/DadosTomador/Contato/Telefone
EmailTomador=LoteRps/ListaRps/Rps/DadosTomador/Contato/Email
RazaoSocialIntermediario=LoteRps/ListaRps/Rps/IdentificacaoIntermediario/RazaoSocial
CpfCnpjIntermediario=LoteRps/ListaRps/Rps/IdentificacaoIntermediario/CpfCnpj
IndicacaoCpfCnpjIntermediario=LoteRps/ListaRps/Rps/IdentificacaoIntermediario/IndicacaoCpfCnpj
InscricaoMunicipalIntermediario=LoteRps/ListaRps/Rps/IdentificacaoIntermediario/InscricaoMunicipal
CodigoCnae=LoteRps/ListaRps/Rps/Servicos/Servico/CodigoCnae
CodigoServico116=LoteRps/ListaRps/Rps/Servicos/Servico/CodigoServico116
CodigoServicoMunicipal=LoteRps/ListaRps/Rps/Servicos/Servico/CodigoServicoMunicipal
Quantidade=LoteRps/ListaRps/Rps/Servicos/Servico/Quantidade
Unidade=LoteRps/ListaRps/Rps/Servicos/Servico/Unidade
Descricao=LoteRps/ListaRps/Rps/Servicos/Servico/Descricao
Aliquota=LoteRps/ListaRps/Rps/Servicos/Servico/Aliquota
ValorServico=LoteRps/ListaRps/Rps/Servicos/Servico/ValorServico
ValorIssqn=LoteRps/ListaRps/Rps/Servicos/Servico/ValorIssqn
ValorDesconto=LoteRps/ListaRps/Rps/Servicos/Servico/ValorDesconto
NumeroAlvara=LoteRps/ListaRps/Rps/Servicos/Servico/NumeroAlvara
ValorServicos=LoteRps/ListaRps/Rps/Valores/ValorServicos
ValorDeducoes=LoteRps/ListaRps/Rps/Valores/ValorDeducoes
ValorPis=LoteRps/ListaRps/Rps/Valores/ValorPis
ValorCofins=LoteRps/ListaRps/Rps/Valores/ValorCofins
ValorInss=LoteRps/ListaRps/Rps/Valores/ValorInss
ValorIr=LoteRps/ListaRps/Rps/Valores/ValorIr
ValorCsll=LoteRps/ListaRps/Rps/Valores/ValorCsll
ValorIss=LoteRps/ListaRps/Rps/Valores/ValorIss
ValorOutrasRetencoes=LoteRps/ListaRps/Rps/Valores/ValorOutrasRetencoes
ValorLiquidoNfse=LoteRps/ListaRps/Rps/Valores/ValorLiquidoNfse
ValorIssRetido=LoteRps/ListaRps/Rps/Valores/ValorIssRetido
OutrosDescontos=LoteRps/ListaRps/Rps/Valores/OutrosDescontos
IdSubstituido=LoteRps/ListaRps/Rps/RpsSubstituido/Id
Observacao=LoteRps/ListaRps/Rps/Observacao
Status=LoteRps/ListaRps/Rps/Status
CodigoMunicipio=LoteRps/ListaRps/Rps/CodigoMunicipioPrestacao

;***************************************************************************************************
;Definições dos Campos: Impressão de NFSe (Impressão Nova)
;***************************************************************************************************
[PrintXml_DadosNFSe]
FILE=MappingImpressaoNFSe.txt

;***************************************************************************************************
;Definições dos Campos: Impressão de RPS (Impressão Nova)
;***************************************************************************************************
[PrintXml_DadosRPS]
FILE=MappingImpressaoRPS.txt

;***************************************************************************************************
;Campos de Configuração da Impressão Nova
;***************************************************************************************************
[PrintXml_Config]
ModoImpressao=String[4]
DiretorioTemplates=String[255]
Titulo=String[80]
BrasaoMunicipio=String[255]
LogotipoEmitente=String[255]
ArquivoMunicipios=String[255]
DebugMode=String[5]
NomeCidade=String[80]
NomePadrao=String[80]
