;***************************************************************************************************
;        ARQUIVO DE MAPEAMENTO PRESIDENTE PRUDENTE - SP
;***************************************************************************************************

;***************************************************************************************************
;Configuração do NFSeDataset para Envio de Lote de RPS (Proxy)
;***************************************************************************************************
[ENVIAR]
XSDElementName=GerarNovaNfseEnvio
XSDFile=nfse_3.xsd
XSDStartNode=
IgnoredXPaths=GerarNovaNfseEnvio/Signature
UseNamespacePrefixes=0
XMLHeader=
RootAttributes=
IgnoreUnknownElements=1

;***************************************************************************************************
;Nomes dos comandos para os respectivos datasets (para uso nos arquivos TX2)
;***************************************************************************************************
[comandos]
GerarNovaNfseEnvio.Insert=INCLUIRITEM
GerarNovaNfseEnvio.Post=SALVARITEM
ItensServico.Insert=INCLUIRITENSSERVICO
ItensServico.Post=SALVARITENSSERVICO

;***************************************************************************************************
;Nomes dos Campos: Envio de Lote de RPS (Proxy)
;***************************************************************************************************
[GerarNovaNfseEnvio]
IdRps=GerarNovaNfseEnvio/InformacaoNfse/@id
CnpjPrestador=GerarNovaNfseEnvio/Prestador/Cnpj
InscricaoMunicipalPrestador=GerarNovaNfseEnvio/Prestador/InscricaoMunicipal
NaturezaOperacao=GerarNovaNfseEnvio/InformacaoNfse/NaturezaOperacao
RegimeEspecialTributacao=GerarNovaNfseEnvio/InformacaoNfse/RegimeEspecialTributacao
OptanteSimplesNacional=GerarNovaNfseEnvio/InformacaoNfse/OptanteSimplesNacional
IncentivadorCultural=GerarNovaNfseEnvio/InformacaoNfse/IncentivadorCultural
Status=GerarNovaNfseEnvio/InformacaoNfse/Status
Competencia=GerarNovaNfseEnvio/InformacaoNfse/Competencia
NfseSubstituida=GerarNovaNfseEnvio/InformacaoNfse/NfseSubstituida
OutrasInformacoes=GerarNovaNfseEnvio/InformacaoNfse/OutrasInformacoes
ValorServicos=GerarNovaNfseEnvio/InformacaoNfse/Servico/Valores/ValorServicos
ValorDeducoes=GerarNovaNfseEnvio/InformacaoNfse/Servico/Valores/ValorDeducoes
ValorPis=GerarNovaNfseEnvio/InformacaoNfse/Servico/Valores/ValorPis
ValorCofins=GerarNovaNfseEnvio/InformacaoNfse/Servico/Valores/ValorCofins
ValorInss=GerarNovaNfseEnvio/InformacaoNfse/Servico/Valores/ValorInss
ValorIr=GerarNovaNfseEnvio/InformacaoNfse/Servico/Valores/ValorIr
ValorCsll=GerarNovaNfseEnvio/InformacaoNfse/Servico/Valores/ValorCsll
IssRetido=GerarNovaNfseEnvio/InformacaoNfse/Servico/Valores/IssRetido
ValorIss=GerarNovaNfseEnvio/InformacaoNfse/Servico/Valores/ValorIss
ValorIssRetido=GerarNovaNfseEnvio/InformacaoNfse/Servico/Valores/ValorIssRetido
OutrasRetencoes=GerarNovaNfseEnvio/InformacaoNfse/Servico/Valores/OutrasRetencoes
BaseCalculo=GerarNovaNfseEnvio/InformacaoNfse/Servico/Valores/BaseCalculo
Aliquota=GerarNovaNfseEnvio/InformacaoNfse/Servico/Valores/Aliquota
ValorLiquidoNfse=GerarNovaNfseEnvio/InformacaoNfse/Servico/Valores/ValorLiquidoNfse
DescontoIncondicionado=GerarNovaNfseEnvio/InformacaoNfse/Servico/Valores/DescontoIncondicionado
DescontoCondicionado=GerarNovaNfseEnvio/InformacaoNfse/Servico/Valores/DescontoCondicionado
ItemListaServico=GerarNovaNfseEnvio/InformacaoNfse/Servico/ItemListaServico
CodigoCnae=GerarNovaNfseEnvio/InformacaoNfse/Servico/CodigoCnae
CodigoTributacaoMunicipio=GerarNovaNfseEnvio/InformacaoNfse/Servico/CodigoTributacaoMunicipio
Discriminacao=GerarNovaNfseEnvio/InformacaoNfse/Servico/Discriminacao
CodigoMunicipio=GerarNovaNfseEnvio/InformacaoNfse/Servico/CodigoMunicipio
CpfTomador=GerarNovaNfseEnvio/InformacaoNfse/Tomador/IdentificacaoTomador/CpfCnpj/Cpf
CnpjTomador=GerarNovaNfseEnvio/InformacaoNfse/Tomador/IdentificacaoTomador/CpfCnpj/Cnpj
InscricaoMunicipalTomador=GerarNovaNfseEnvio/InformacaoNfse/Tomador/IdentificacaoTomador/InscricaoMunicipal
InscricaoEstadualTomador=GerarNovaNfseEnvio/InformacaoNfse/Tomador/IdentificacaoTomador/InscricaoEstadual
RazaoSocialTomador=GerarNovaNfseEnvio/InformacaoNfse/Tomador/RazaoSocial
EnderecoTomador=GerarNovaNfseEnvio/InformacaoNfse/Tomador/Endereco/Endereco
NumeroTomador=GerarNovaNfseEnvio/InformacaoNfse/Tomador/Endereco/Numero
ComplementoTomador=GerarNovaNfseEnvio/InformacaoNfse/Tomador/Endereco/Complemento
BairroTomador=GerarNovaNfseEnvio/InformacaoNfse/Tomador/Endereco/Bairro
CodigoMunicipioTomador=GerarNovaNfseEnvio/InformacaoNfse/Tomador/Endereco/CodigoMunicipio
UfTomador=GerarNovaNfseEnvio/InformacaoNfse/Tomador/Endereco/Uf
CepTomador=GerarNovaNfseEnvio/InformacaoNfse/Tomador/Endereco/Cep
TelefoneTomador=GerarNovaNfseEnvio/InformacaoNfse/Tomador/Contato/Telefone
EmailTomador=GerarNovaNfseEnvio/InformacaoNfse/Tomador/Contato/Email
RazaoSocialIntermediario=GerarNovaNfseEnvio/InformacaoNfse/IntermediarioServico/RazaoSocial
CpfIntermediario=GerarNovaNfseEnvio/InformacaoNfse/IntermediarioServico/CpfCnpj/Cpf
CnpjIntermediario=GerarNovaNfseEnvio/InformacaoNfse/IntermediarioServico/CpfCnpj/Cnpj
InscricaoMunicipalIntermediario=GerarNovaNfseEnvio/InformacaoNfse/IntermediarioServico/InscricaoMunicipal
CodigoObra=GerarNovaNfseEnvio/InformacaoNfse/ContrucaoCivil/CodigoObra
Art=GerarNovaNfseEnvio/InformacaoNfse/ContrucaoCivil/Art

;Itens Servico
Descricao=GerarNovaNfseEnvio/InformacaoNfse/Servico/ItensServico/Descricao
Quantidade=GerarNovaNfseEnvio/InformacaoNfse/Servico/ItensServico/Quantidade
ValorUnitario=GerarNovaNfseEnvio/InformacaoNfse/Servico/ItensServico/ValorUnitario
IssTributavel=GerarNovaNfseEnvio/InformacaoNfse/Servico/ItensServico/IssTributavel

;***************************************************************************************************
;Definições dos Campos: Impressão de NFSe (Impressão Nova)
;***************************************************************************************************
[PrintXml_DadosNFSe]
FILE=MappingImpressao.txt

;***************************************************************************************************
;Definições dos Campos: Impressão de RPS (Impressão Nova)
;***************************************************************************************************
[PrintXml_DadosRPS]
FILE=MappingImpressaoRPS_Sincrono.txt

;***************************************************************************************************
;Campos de Configuração da Impressão Nova
;***************************************************************************************************
[PrintXml_Config]
ModoImpressao=String[4]
DiretorioTemplates=String[255]
Titulo=String[80]
BrasaoMunicipio=String[255]
LogotipoEmitente=String[255]
ArquivoMunicipios=String[255]
DebugMode=String[5]
