;***************************************************************************************************
;        ARQUIVO DE MAPEAMENTO PARA EQUIPLANO
;***************************************************************************************************

;***************************************************************************************************
;Configuração do NFSeDataset para Envio de Lote de RPS (Proxy)
;***************************************************************************************************
[ENVIAR]
XSDElementName=enviarLoteRpsEnvio
XSDFile=esRecepcionarLoteRpsEnvio_v01.xsd
XSDStartNode=
IgnoredXPaths=enviarLoteRpsEnvio/Signature
UseNamespacePrefixes=0
XMLHeader=
RootAttributes=

;***************************************************************************************************
;Nomes dos comandos para os respectivos datasets (para uso nos arquivos TX2)
;***************************************************************************************************
[comandos]
enviarLoteRpsEnvio.Insert=INCLUIR
enviarLoteRpsEnvio.Post=SALVAR
rps.Insert=INCLUIRRPS
rps.Post=SALVARRPS
servico.Insert=INCLUIRSERVICO
servico.Post=SALVARSERVICO

;***************************************************************************************************
;Nomes dos Campos: Envio de Lote de RPS (Proxy)
;***************************************************************************************************
[enviarLoteRpsEnvio]
nrLote=enviarLoteRpsEnvio/lote/nrLote
qtRps=enviarLoteRpsEnvio/lote/qtRps
nrVersaoXml=enviarLoteRpsEnvio/lote/nrVersaoXml
nrCnpj=enviarLoteRpsEnvio/lote/prestador/nrCnpj
nrInscricaoMunicipal=enviarLoteRpsEnvio/lote/prestador/nrInscricaoMunicipal
isOptanteSimplesNacional=enviarLoteRpsEnvio/lote/prestador/isOptanteSimplesNacional
idEntidade=enviarLoteRpsEnvio/lote/prestador/idEntidade
nrRps=enviarLoteRpsEnvio/lote/listaRps/rps/nrRps
nrEmissorRps=enviarLoteRpsEnvio/lote/listaRps/rps/nrEmissorRps
dtEmissaoRps=enviarLoteRpsEnvio/lote/listaRps/rps/dtEmissaoRps
stRps=enviarLoteRpsEnvio/lote/listaRps/rps/stRps
tpTributacao=enviarLoteRpsEnvio/lote/listaRps/rps/tpTributacao
isIssRetido=enviarLoteRpsEnvio/lote/listaRps/rps/isIssRetido
nrDocumento=enviarLoteRpsEnvio/lote/listaRps/rps/tomador/documento/nrDocumento
tpDocumento=enviarLoteRpsEnvio/lote/listaRps/rps/tomador/documento/tpDocumento
dsDocumentoEstrangeiro=enviarLoteRpsEnvio/lote/listaRps/rps/tomador/documento/dsDocumentoEstrangeiro
nmTomador=enviarLoteRpsEnvio/lote/listaRps/rps/tomador/nmTomador
dsEmail=enviarLoteRpsEnvio/lote/listaRps/rps/tomador/dsEmail
nrInscricaoEstadual=enviarLoteRpsEnvio/lote/listaRps/rps/tomador/nrInscricaoEstadual
dsEndereco=enviarLoteRpsEnvio/lote/listaRps/rps/tomador/dsEndereco
nrEndereco=enviarLoteRpsEnvio/lote/listaRps/rps/tomador/nrEndereco
dsComplemento=enviarLoteRpsEnvio/lote/listaRps/rps/tomador/dsComplemento
nmBairro=enviarLoteRpsEnvio/lote/listaRps/rps/tomador/nmBairro
nrCidadeIbge=enviarLoteRpsEnvio/lote/listaRps/rps/tomador/nrCidadeIbge
nmUf=enviarLoteRpsEnvio/lote/listaRps/rps/tomador/nmUf
nmCidadeEstrangeira=enviarLoteRpsEnvio/lote/listaRps/rps/tomador/nmCidadeEstrangeira
nmPais=enviarLoteRpsEnvio/lote/listaRps/rps/tomador/nmPais
nrCep=enviarLoteRpsEnvio/lote/listaRps/rps/tomador/nrCep
nrTelefone=enviarLoteRpsEnvio/lote/listaRps/rps/tomador/nrTelefone
vlTotalRps=enviarLoteRpsEnvio/lote/listaRps/rps/vlTotalRps
vlLiquidoRps=enviarLoteRpsEnvio/lote/listaRps/rps/vlLiquidoRps
vlCofins=enviarLoteRpsEnvio/lote/listaRps/rps/retencoes/vlCofins
vlCsll=enviarLoteRpsEnvio/lote/listaRps/rps/retencoes/vlCsll
vlInss=enviarLoteRpsEnvio/lote/listaRps/rps/retencoes/vlInss
vlIrrf=enviarLoteRpsEnvio/lote/listaRps/rps/retencoes/vlIrrf
vlPis=enviarLoteRpsEnvio/lote/listaRps/rps/retencoes/vlPis
vlIss=enviarLoteRpsEnvio/lote/listaRps/rps/retencoes/vlIss
vlAliquotaCofins=enviarLoteRpsEnvio/lote/listaRps/rps/retencoes/vlAliquotaCofins
vlAliquotaCsll=enviarLoteRpsEnvio/lote/listaRps/rps/retencoes/vlAliquotaCsll
vlAliquotaInss=enviarLoteRpsEnvio/lote/listaRps/rps/retencoes/vlAliquotaInss
vlAliquotaIrrf=enviarLoteRpsEnvio/lote/listaRps/rps/retencoes/vlAliquotaIrrf
vlAliquotaPis=enviarLoteRpsEnvio/lote/listaRps/rps/retencoes/vlAliquotaPis
nrServicoItem=enviarLoteRpsEnvio/lote/listaRps/rps/listaServicos/servico/nrServicoItem
nrServicoSubItem=enviarLoteRpsEnvio/lote/listaRps/rps/listaServicos/servico/nrServicoSubItem
vlServico=enviarLoteRpsEnvio/lote/listaRps/rps/listaServicos/servico/vlServico
vlAliquota=enviarLoteRpsEnvio/lote/listaRps/rps/listaServicos/servico/vlAliquota
vlDeducao=enviarLoteRpsEnvio/lote/listaRps/rps/listaServicos/servico/deducao/vlDeducao
dsJustificativaDeducao=enviarLoteRpsEnvio/lote/listaRps/rps/listaServicos/servico/deducao/dsJustificativaDeducao
vlBaseCalculo=enviarLoteRpsEnvio/lote/listaRps/rps/listaServicos/servico/vlBaseCalculo
vlIssServico=enviarLoteRpsEnvio/lote/listaRps/rps/listaServicos/servico/vlIssServico
dsDiscriminacaoServico=enviarLoteRpsEnvio/lote/listaRps/rps/listaServicos/servico/dsDiscriminacaoServico

;***************************************************************************************************
;Definições dos Campos: Impressão de NFSe (Impressão Nova)
;***************************************************************************************************
[PrintXml_DadosNFSe]
FILE=MappingImpressao.txt

;***************************************************************************************************
;Definições dos Campos: Impressão de RPS (Impressão Nova)
;***************************************************************************************************
[PrintXml_DadosRPS]
FILE=MappingImpressao.txt

;***************************************************************************************************
;Campos de Configuração da Impressão Nova
;***************************************************************************************************
[PrintXml_Config]
ModoImpressao=String[4]
DiretorioTemplates=String[255]
Titulo=String[80]
BrasaoMunicipio=String[255]
LogotipoEmitente=String[255]
ArquivoMunicipios=String[255]
SecretariaResponsavel=String[255]
SubtituloNFSe=String[255]
SubtituloRPS=String[255]
DebugMode=String[5]
NomeCidade=String[80]
NomePadrao=String[20]
