;***************************************************************************************************
;        ARQUIVO DE MAPEAMENTO PARA O PADRÃO TecnoSistemas
;***************************************************************************************************

;***************************************************************************************************
;Configuração do NFSeDataset para Envio de Lote de RPS (Proxy)
;***************************************************************************************************
[ENVIAR]
XSDElementName=EnviarLoteRpsSincronoEnvio
XSDFile=nfse_v1_2.xsd
XSDStartNode=
IgnoredXPaths=
UseNamespacePrefixes=0
XMLHeader=
RootAttributes=

;***************************************************************************************************
;Nomes dos comandos para os respectivos datasets (para uso nos arquivos TX2)
;***************************************************************************************************
[comandos]
EnviarLoteRpsSincronoEnvio.Insert=INCLUIR
EnviarLoteRpsSincronoEnvio.Post=SALVAR
Rps.Insert=INCLUIRITEM
Rps.Post=SALVARITEM

;***************************************************************************************************
;Nomes dos Campos: Envio de Lote de RPS (Proxy)
;***************************************************************************************************
[EnviarLoteRpsSincronoEnvio]
IdLote=EnviarLoteRpsSincronoEnvio/LoteRps/@Id
NumeroLote=EnviarLoteRpsSincronoEnvio/LoteRps/NumeroLote
Cnpj=EnviarLoteRpsSincronoEnvio/LoteRps/CpfCnpj/Cnpj
InscricaoMunicipal=EnviarLoteRpsSincronoEnvio/LoteRps/InscricaoMunicipal
versao=EnviarLoteRpsSincronoEnvio/LoteRps/@versao
QuantidadeRps=EnviarLoteRpsSincronoEnvio/LoteRps/QuantidadeRps
NumeroRps=EnviarLoteRpsSincronoEnvio/LoteRps/ListaRps/Rps/tcDeclaracaoPrestacaoServico/InfDeclaracaoPrestacaoServico/Rps/IdentificacaoRps/Numero
SerieRps=EnviarLoteRpsSincronoEnvio/LoteRps/ListaRps/Rps/tcDeclaracaoPrestacaoServico/InfDeclaracaoPrestacaoServico/Rps/IdentificacaoRps/Serie
TipoRps=EnviarLoteRpsSincronoEnvio/LoteRps/ListaRps/Rps/tcDeclaracaoPrestacaoServico/InfDeclaracaoPrestacaoServico/Rps/IdentificacaoRps/Tipo
DataEmissao=EnviarLoteRpsSincronoEnvio/LoteRps/ListaRps/Rps/tcDeclaracaoPrestacaoServico/InfDeclaracaoPrestacaoServico/Rps/DataEmissao
Status=EnviarLoteRpsSincronoEnvio/LoteRps/ListaRps/Rps/tcDeclaracaoPrestacaoServico/InfDeclaracaoPrestacaoServico/Rps/Status
NumeroRpsSubstituido=EnviarLoteRpsSincronoEnvio/LoteRps/ListaRps/Rps/tcDeclaracaoPrestacaoServico/InfDeclaracaoPrestacaoServico/Rps/RpsSubstituido/Numero
SerieRpsSubstituido=EnviarLoteRpsSincronoEnvio/LoteRps/ListaRps/Rps/tcDeclaracaoPrestacaoServico/InfDeclaracaoPrestacaoServico/Rps/RpsSubstituido/Serie
TipoRpsSubstituido=EnviarLoteRpsSincronoEnvio/LoteRps/ListaRps/Rps/tcDeclaracaoPrestacaoServico/InfDeclaracaoPrestacaoServico/Rps/RpsSubstituido/Tipo
Competencia=EnviarLoteRpsSincronoEnvio/LoteRps/ListaRps/Rps/tcDeclaracaoPrestacaoServico/InfDeclaracaoPrestacaoServico/Competencia
BaseCalculoCRS=EnviarLoteRpsSincronoEnvio/LoteRps/ListaRps/Rps/tcDeclaracaoPrestacaoServico/InfDeclaracaoPrestacaoServico/Servico/tcDadosServico/Valores/BaseCalculoCRS
IrrfIndenizacao=EnviarLoteRpsSincronoEnvio/LoteRps/ListaRps/Rps/tcDeclaracaoPrestacaoServico/InfDeclaracaoPrestacaoServico/Servico/tcDadosServico/Valores/IrrfIndenizacao
ValorServicos=EnviarLoteRpsSincronoEnvio/LoteRps/ListaRps/Rps/tcDeclaracaoPrestacaoServico/InfDeclaracaoPrestacaoServico/Servico/tcDadosServico/Valores/ValorServicos
ValorDeducoes=EnviarLoteRpsSincronoEnvio/LoteRps/ListaRps/Rps/tcDeclaracaoPrestacaoServico/InfDeclaracaoPrestacaoServico/Servico/tcDadosServico/Valores/ValorDeducoes
ValorPis=EnviarLoteRpsSincronoEnvio/LoteRps/ListaRps/Rps/tcDeclaracaoPrestacaoServico/InfDeclaracaoPrestacaoServico/Servico/tcDadosServico/Valores/ValorPis
ValorCofins=EnviarLoteRpsSincronoEnvio/LoteRps/ListaRps/Rps/tcDeclaracaoPrestacaoServico/InfDeclaracaoPrestacaoServico/Servico/tcDadosServico/Valores/ValorCofins
ValorInss=EnviarLoteRpsSincronoEnvio/LoteRps/ListaRps/Rps/tcDeclaracaoPrestacaoServico/InfDeclaracaoPrestacaoServico/Servico/tcDadosServico/Valores/ValorInss
ValorIr=EnviarLoteRpsSincronoEnvio/LoteRps/ListaRps/Rps/tcDeclaracaoPrestacaoServico/InfDeclaracaoPrestacaoServico/Servico/tcDadosServico/Valores/ValorIr
ValorCsll=EnviarLoteRpsSincronoEnvio/LoteRps/ListaRps/Rps/tcDeclaracaoPrestacaoServico/InfDeclaracaoPrestacaoServico/Servico/tcDadosServico/Valores/ValorCsll
OutrasRetencoes=EnviarLoteRpsSincronoEnvio/LoteRps/ListaRps/Rps/tcDeclaracaoPrestacaoServico/InfDeclaracaoPrestacaoServico/Servico/tcDadosServico/Valores/OutrasRetencoes
ValorIss=EnviarLoteRpsSincronoEnvio/LoteRps/ListaRps/Rps/tcDeclaracaoPrestacaoServico/InfDeclaracaoPrestacaoServico/Servico/tcDadosServico/Valores/ValorIss
Aliquota=EnviarLoteRpsSincronoEnvio/LoteRps/ListaRps/Rps/tcDeclaracaoPrestacaoServico/InfDeclaracaoPrestacaoServico/Servico/tcDadosServico/Valores/Aliquota
DescontoIncondicionado=EnviarLoteRpsSincronoEnvio/LoteRps/ListaRps/Rps/tcDeclaracaoPrestacaoServico/InfDeclaracaoPrestacaoServico/Servico/tcDadosServico/Valores/DescontoIncondicionado
DescontoCondicionado=EnviarLoteRpsSincronoEnvio/LoteRps/ListaRps/Rps/tcDeclaracaoPrestacaoServico/InfDeclaracaoPrestacaoServico/Servico/tcDadosServico/Valores/DescontoCondicionado
IssRetido=EnviarLoteRpsSincronoEnvio/LoteRps/ListaRps/Rps/tcDeclaracaoPrestacaoServico/InfDeclaracaoPrestacaoServico/Servico/tcDadosServico/IssRetido
ResponsavelRetencao=EnviarLoteRpsSincronoEnvio/LoteRps/ListaRps/Rps/tcDeclaracaoPrestacaoServico/InfDeclaracaoPrestacaoServico/Servico/tcDadosServico/ResponsavelRetencao
ItemListaServico=EnviarLoteRpsSincronoEnvio/LoteRps/ListaRps/Rps/tcDeclaracaoPrestacaoServico/InfDeclaracaoPrestacaoServico/Servico/tcDadosServico/ItemListaServico
CodigoCnae=EnviarLoteRpsSincronoEnvio/LoteRps/ListaRps/Rps/tcDeclaracaoPrestacaoServico/InfDeclaracaoPrestacaoServico/Servico/tcDadosServico/CodigoCnae
CodigoTributacaoMunicipio=EnviarLoteRpsSincronoEnvio/LoteRps/ListaRps/Rps/tcDeclaracaoPrestacaoServico/InfDeclaracaoPrestacaoServico/Servico/tcDadosServico/CodigoTributacaoMunicipio
Discriminacao=EnviarLoteRpsSincronoEnvio/LoteRps/ListaRps/Rps/tcDeclaracaoPrestacaoServico/InfDeclaracaoPrestacaoServico/Servico/tcDadosServico/Discriminacao
CodigoMunicipio=EnviarLoteRpsSincronoEnvio/LoteRps/ListaRps/Rps/tcDeclaracaoPrestacaoServico/InfDeclaracaoPrestacaoServico/Servico/tcDadosServico/CodigoMunicipio
CodigoPais=EnviarLoteRpsSincronoEnvio/LoteRps/ListaRps/Rps/tcDeclaracaoPrestacaoServico/InfDeclaracaoPrestacaoServico/Servico/tcDadosServico/CodigoPais
ExigibilidadeISS=EnviarLoteRpsSincronoEnvio/LoteRps/ListaRps/Rps/tcDeclaracaoPrestacaoServico/InfDeclaracaoPrestacaoServico/Servico/tcDadosServico/ExigibilidadeISS
MunicipioIncidencia=EnviarLoteRpsSincronoEnvio/LoteRps/ListaRps/Rps/tcDeclaracaoPrestacaoServico/InfDeclaracaoPrestacaoServico/Servico/tcDadosServico/MunicipioIncidencia
NumeroProcesso=EnviarLoteRpsSincronoEnvio/LoteRps/ListaRps/Rps/tcDeclaracaoPrestacaoServico/InfDeclaracaoPrestacaoServico/Servico/tcDadosServico/NumeroProcesso
CnpjPrestador=EnviarLoteRpsSincronoEnvio/LoteRps/ListaRps/Rps/tcDeclaracaoPrestacaoServico/InfDeclaracaoPrestacaoServico/Prestador/CpfCnpj/Cnpj
RazaoSocialPrestador=EnviarLoteRpsSincronoEnvio/LoteRps/ListaRps/Rps/tcDeclaracaoPrestacaoServico/InfDeclaracaoPrestacaoServico/Prestador/RazaoSocial
InscricaoMunicipalPrestador=EnviarLoteRpsSincronoEnvio/LoteRps/ListaRps/Rps/tcDeclaracaoPrestacaoServico/InfDeclaracaoPrestacaoServico/Prestador/InscricaoMunicipal
CpfTomador=EnviarLoteRpsSincronoEnvio/LoteRps/ListaRps/Rps/tcDeclaracaoPrestacaoServico/InfDeclaracaoPrestacaoServico/Tomador/IdentificacaoTomador/CpfCnpj/Cpf
CnpjTomador=EnviarLoteRpsSincronoEnvio/LoteRps/ListaRps/Rps/tcDeclaracaoPrestacaoServico/InfDeclaracaoPrestacaoServico/Tomador/IdentificacaoTomador/CpfCnpj/Cnpj
InscricaoMunicipalTomador=EnviarLoteRpsSincronoEnvio/LoteRps/ListaRps/Rps/tcDeclaracaoPrestacaoServico/InfDeclaracaoPrestacaoServico/Tomador/IdentificacaoTomador/InscricaoMunicipal
RazaoSocialTomador=EnviarLoteRpsSincronoEnvio/LoteRps/ListaRps/Rps/tcDeclaracaoPrestacaoServico/InfDeclaracaoPrestacaoServico/Tomador/RazaoSocial
Endereco=EnviarLoteRpsSincronoEnvio/LoteRps/ListaRps/Rps/tcDeclaracaoPrestacaoServico/InfDeclaracaoPrestacaoServico/Tomador/Endereco/Endereco
NumeroTomador=EnviarLoteRpsSincronoEnvio/LoteRps/ListaRps/Rps/tcDeclaracaoPrestacaoServico/InfDeclaracaoPrestacaoServico/Tomador/Endereco/Numero
Complemento=EnviarLoteRpsSincronoEnvio/LoteRps/ListaRps/Rps/tcDeclaracaoPrestacaoServico/InfDeclaracaoPrestacaoServico/Tomador/Endereco/Complemento
Bairro=EnviarLoteRpsSincronoEnvio/LoteRps/ListaRps/Rps/tcDeclaracaoPrestacaoServico/InfDeclaracaoPrestacaoServico/Tomador/Endereco/Bairro
CodigoMunicipioTomador=EnviarLoteRpsSincronoEnvio/LoteRps/ListaRps/Rps/tcDeclaracaoPrestacaoServico/InfDeclaracaoPrestacaoServico/Tomador/Endereco/CodigoMunicipio
Uf=EnviarLoteRpsSincronoEnvio/LoteRps/ListaRps/Rps/tcDeclaracaoPrestacaoServico/InfDeclaracaoPrestacaoServico/Tomador/Endereco/Uf
CodigoPaisTomador=EnviarLoteRpsSincronoEnvio/LoteRps/ListaRps/Rps/tcDeclaracaoPrestacaoServico/InfDeclaracaoPrestacaoServico/Tomador/Endereco/CodigoPais
Cep=EnviarLoteRpsSincronoEnvio/LoteRps/ListaRps/Rps/tcDeclaracaoPrestacaoServico/InfDeclaracaoPrestacaoServico/Tomador/Endereco/Cep
Telefone=EnviarLoteRpsSincronoEnvio/LoteRps/ListaRps/Rps/tcDeclaracaoPrestacaoServico/InfDeclaracaoPrestacaoServico/Tomador/Contato/Telefone
Email=EnviarLoteRpsSincronoEnvio/LoteRps/ListaRps/Rps/tcDeclaracaoPrestacaoServico/InfDeclaracaoPrestacaoServico/Tomador/Contato/Email
CpfIntermediario=EnviarLoteRpsSincronoEnvio/LoteRps/ListaRps/Rps/tcDeclaracaoPrestacaoServico/InfDeclaracaoPrestacaoServico/Intermediario/IdentificacaoIntermediario/CpfCnpj/Cpf
CnpjIntermediario=EnviarLoteRpsSincronoEnvio/LoteRps/ListaRps/Rps/tcDeclaracaoPrestacaoServico/InfDeclaracaoPrestacaoServico/Intermediario/IdentificacaoIntermediario/CpfCnpj/Cnpj
InscricaoMunicipal=EnviarLoteRpsSincronoEnvio/LoteRps/ListaRps/Rps/tcDeclaracaoPrestacaoServico/InfDeclaracaoPrestacaoServico/Intermediario/IdentificacaoIntermediario/InscricaoMunicipal
RazaoSocialIntermediario=EnviarLoteRpsSincronoEnvio/LoteRps/ListaRps/Rps/tcDeclaracaoPrestacaoServico/InfDeclaracaoPrestacaoServico/Intermediario/RazaoSocial
CodigoObra=EnviarLoteRpsSincronoEnvio/LoteRps/ListaRps/Rps/tcDeclaracaoPrestacaoServico/InfDeclaracaoPrestacaoServico/ConstrucaoCivil/CodigoObra
Art=EnviarLoteRpsSincronoEnvio/LoteRps/ListaRps/Rps/tcDeclaracaoPrestacaoServico/InfDeclaracaoPrestacaoServico/ConstrucaoCivil/Art
RegimeEspecialTributacao=EnviarLoteRpsSincronoEnvio/LoteRps/ListaRps/Rps/tcDeclaracaoPrestacaoServico/InfDeclaracaoPrestacaoServico/RegimeEspecialTributacao
NaturezaOperacao=EnviarLoteRpsSincronoEnvio/LoteRps/ListaRps/Rps/tcDeclaracaoPrestacaoServico/InfDeclaracaoPrestacaoServico/NaturezaOperacao
OptanteSimplesNacional=EnviarLoteRpsSincronoEnvio/LoteRps/ListaRps/Rps/tcDeclaracaoPrestacaoServico/InfDeclaracaoPrestacaoServico/OptanteSimplesNacional
IncentivoFiscal=EnviarLoteRpsSincronoEnvio/LoteRps/ListaRps/Rps/tcDeclaracaoPrestacaoServico/InfDeclaracaoPrestacaoServico/IncentivoFiscal
PercentualCargaTributaria=EnviarLoteRpsSincronoEnvio/LoteRps/ListaRps/Rps/tcDeclaracaoPrestacaoServico/InfDeclaracaoPrestacaoServico/PercentualCargaTributaria
ValorCargaTributaria=EnviarLoteRpsSincronoEnvio/LoteRps/ListaRps/Rps/tcDeclaracaoPrestacaoServico/InfDeclaracaoPrestacaoServico/ValorCargaTributaria
PercentualCargaTributMunicipal=EnviarLoteRpsSincronoEnvio/LoteRps/ListaRps/Rps/tcDeclaracaoPrestacaoServico/InfDeclaracaoPrestacaoServico/PercentualCargaTributariaMunicipal
ValorCargaTributariaMunicipal=EnviarLoteRpsSincronoEnvio/LoteRps/ListaRps/Rps/tcDeclaracaoPrestacaoServico/InfDeclaracaoPrestacaoServico/ValorCargaTributariaMunicipal
PercentualCargaTributEstadual=EnviarLoteRpsSincronoEnvio/LoteRps/ListaRps/Rps/tcDeclaracaoPrestacaoServico/InfDeclaracaoPrestacaoServico/PercentualCargaTributariaEstadual
ValorCargaTributariaEstadual=EnviarLoteRpsSincronoEnvio/LoteRps/ListaRps/Rps/tcDeclaracaoPrestacaoServico/InfDeclaracaoPrestacaoServico/ValorCargaTributariaEstadual
OutrasInformacoes=EnviarLoteRpsSincronoEnvio/LoteRps/ListaRps/Rps/tcDeclaracaoPrestacaoServico/InfDeclaracaoPrestacaoServico/OutrasInformacoes
TipoNota=EnviarLoteRpsSincronoEnvio/LoteRps/ListaRps/Rps/tcDeclaracaoPrestacaoServico/InfDeclaracaoPrestacaoServico/TipoNota
SiglaUF=EnviarLoteRpsSincronoEnvio/LoteRps/ListaRps/Rps/tcDeclaracaoPrestacaoServico/InfDeclaracaoPrestacaoServico/SiglaUF
IdCidade=EnviarLoteRpsSincronoEnvio/LoteRps/ListaRps/Rps/tcDeclaracaoPrestacaoServico/InfDeclaracaoPrestacaoServico/IdCidade
EspecieDocumento=EnviarLoteRpsSincronoEnvio/LoteRps/ListaRps/Rps/tcDeclaracaoPrestacaoServico/InfDeclaracaoPrestacaoServico/EspecieDocumento
SerieTalonario=EnviarLoteRpsSincronoEnvio/LoteRps/ListaRps/Rps/tcDeclaracaoPrestacaoServico/InfDeclaracaoPrestacaoServico/SerieTalonario
FormaPagamento=EnviarLoteRpsSincronoEnvio/LoteRps/ListaRps/Rps/tcDeclaracaoPrestacaoServico/InfDeclaracaoPrestacaoServico/FormaPagamento
NumeroParcelas=EnviarLoteRpsSincronoEnvio/LoteRps/ListaRps/Rps/tcDeclaracaoPrestacaoServico/InfDeclaracaoPrestacaoServico/NumeroParcelas

;***************************************************************************************************
;Definições dos Campos: Impressão de NFSe (Impressão Nova)
;***************************************************************************************************
[PrintXml_DadosNFSe]
FILE=MappingImpressaoNFSe.txt

;***************************************************************************************************
;Definições dos Campos: Impressão de RPS (Impressão Nova)
;***************************************************************************************************
[PrintXml_DadosRPS]
FILE=MappingImpressaoRPS.txt

;***************************************************************************************************
;Campos de Configuração da Impressão Nova
;***************************************************************************************************
[PrintXml_Config]
ModoImpressao=String[4]
DiretorioTemplates=String[255]
Titulo=String[80]
BrasaoMunicipio=String[255]
LogotipoEmitente=String[255]
ArquivoMunicipios=String[255]
DebugMode=String[5]
NomeCidade=String[80]
NomePadrao=String[80]
