;***************************************************************************************************
;        ARQUIVO DE MAPEAMENTO PARA Caxias do Sul - RS
;***************************************************************************************************

;***************************************************************************************************
;Configuração do NFSeDataset para Envio de Lote de RPS (Proxy)
;***************************************************************************************************
[ENVIAR]
XSDElementName=envioLote
XSDFile=nfse-infisc-v2.xsd
XSDStartNode=
IgnoredXPaths=envioLote/Signature
UseNamespacePrefixes=0
XMLHeader=
RootAttributes=

;***************************************************************************************************
;Nomes dos comandos para os respectivos datasets (para uso nos arquivos TX2)
;***************************************************************************************************
[comandos]
envioLote.Insert=INCLUIR
envioLote.Post=SALVAR
NFS_e.Insert=INCLUIRRPS
NFS_e.Post=SALVARRPS
motCanc.Insert=INCLUIRMOTCANC
motCanc.Post=SALVARMOTCANC
det.Insert=INCLUIRDET
det.Post=SALVARDET
fat.Insert=INCLUIRFAT
fat.Post=SALVARFAT
infAdic.Insert=INCLUIRINFADIC
infAdic.Post=SALVARINFADIC

;***************************************************************************************************
;Nomes dos Campos: Envio de Lote de RPS (Proxy)
;***************************************************************************************************
[envioLote]
; Informações do lote
CNPJ=envioLote/CNPJ
dhTrans=envioLote/dhTrans

; Informações da Nfse
versao=envioLote/@versao
cNFS_e=envioLote/NFS_e/infNFSe/Id/cNFS_e
mod=envioLote/NFS_e/infNFSe/Id/mod
serie=envioLote/NFS_e/infNFSe/Id/serie
nNFS_e=envioLote/NFS_e/infNFSe/Id/nNFS_e
dEmi=envioLote/NFS_e/infNFSe/Id/dEmi
hEmi=envioLote/NFS_e/infNFSe/Id/hEmi
tpNF=envioLote/NFS_e/infNFSe/Id/tpNF
refNF=envioLote/NFS_e/infNFSe/Id/refNF
tpImp=envioLote/NFS_e/infNFSe/Id/tpImp
tpEmis=envioLote/NFS_e/infNFSe/Id/tpEmis
cancelada=envioLote/NFS_e/infNFSe/Id/cancelada
motCanc=envioLote/NFS_e/infNFSe/Id/motCanc
dataCanc=envioLote/NFS_e/infNFSe/Id/dataCanc
notaSub=envioLote/NFS_e/infNFSe/Id/notaSub
canhoto=envioLote/NFS_e/infNFSe/Id/canhoto
rps=envioLote/NFS_e/infNFSe/Id/rps
serierps=envioLote/NFS_e/infNFSe/Id/serierps
codRPS=envioLote/NFS_e/infNFSe/Id/codRPS
ambienteEmi=envioLote/NFS_e/infNFSe/Id/ambienteEmi
formaEmi=envioLote/NFS_e/infNFSe/Id/formaEmi
empreitadaGlobal=envioLote/NFS_e/infNFSe/Id/empreitadaGlobal

; Informações do Prestador
CNPJ=envioLote/NFS_e/infNFSe/prest/CNPJ
xNome=envioLote/NFS_e/infNFSe/prest/xNome
xFant=envioLote/NFS_e/infNFSe/prest/xFant
IM=envioLote/NFS_e/infNFSe/prest/IM
xEmail=envioLote/NFS_e/infNFSe/prest/xEmail
xSite=envioLote/NFS_e/infNFSe/prest/xSite
xLgr=envioLote/NFS_e/infNFSe/prest/end/xLgr
nro=envioLote/NFS_e/infNFSe/prest/end/nro
xCpl=envioLote/NFS_e/infNFSe/prest/end/xCpl
xBairro=envioLote/NFS_e/infNFSe/prest/end/xBairro
cMun=envioLote/NFS_e/infNFSe/prest/end/cMun
xMun=envioLote/NFS_e/infNFSe/prest/end/xMun
UF=envioLote/NFS_e/infNFSe/prest/end/UF
CEP=envioLote/NFS_e/infNFSe/prest/end/CEP
cPais=envioLote/NFS_e/infNFSe/prest/end/cPais
xPais=envioLote/NFS_e/infNFSe/prest/end/xPais
fone=envioLote/NFS_e/infNFSe/prest/fone
fone2=envioLote/NFS_e/infNFSe/prest/fone2
IE=envioLote/NFS_e/infNFSe/prest/IE
regimeTrib=envioLote/NFS_e/infNFSe/prest/regimeTrib

; Informações do Tomador
CNPJTomador=envioLote/NFS_e/infNFSe/TomS/CNPJ
CPFTomador=envioLote/NFS_e/infNFSe/TomS/CPF
xNomeTomador=envioLote/NFS_e/infNFSe/TomS/xNome
xLgrTomador=envioLote/NFS_e/infNFSe/TomS/ender/xLgr
nroTomador=envioLote/NFS_e/infNFSe/TomS/ender/nro
xCplTomador=envioLote/NFS_e/infNFSe/TomS/ender/xCpl
xBairroTomador=envioLote/NFS_e/infNFSe/TomS/ender/xBairro
cMunTomador=envioLote/NFS_e/infNFSe/TomS/ender/cMun
xMunTomador=envioLote/NFS_e/infNFSe/TomS/ender/xMun
UFTomador=envioLote/NFS_e/infNFSe/TomS/ender/UF
CEPTomador=envioLote/NFS_e/infNFSe/TomS/ender/CEP
cPaisTomador=envioLote/NFS_e/infNFSe/TomS/ender/cPais
xPaisTomador=envioLote/NFS_e/infNFSe/TomS/ender/xPais
xEmailTomador=envioLote/NFS_e/infNFSe/TomS/xEmail
IETomador=envioLote/NFS_e/infNFSe/TomS/IE
IMTomador=envioLote/NFS_e/infNFSe/TomS/IM
IME=envioLote/NFS_e/infNFSe/TomS/IME
foneTomador=envioLote/NFS_e/infNFSe/TomS/fone
fone2Tomador=envioLote/NFS_e/infNFSe/TomS/fone2

; Informações referentes à obra
xLogObra=envioLote/NFS_e/infNFSe/dadosDaObra/xLogObra
xComplObra=envioLote/NFS_e/infNFSe/dadosDaObra/xComplObra
vNumeroObra=envioLote/NFS_e/infNFSe/dadosDaObra/vNumeroObra
xBairroObra=envioLote/NFS_e/infNFSe/dadosDaObra/xBairroObra
xCepObra=envioLote/NFS_e/infNFSe/dadosDaObra/xCepObra
cCidadeObra=envioLote/NFS_e/infNFSe/dadosDaObra/cCidadeObra
xCidadeObra=envioLote/NFS_e/infNFSe/dadosDaObra/xCidadeObra
xUfObra=envioLote/NFS_e/infNFSe/dadosDaObra/xUfObra
cPaisObra=envioLote/NFS_e/infNFSe/dadosDaObra/cPaisObra
xPaisObra=envioLote/NFS_e/infNFSe/dadosDaObra/xPaisObra
numeroArt=envioLote/NFS_e/infNFSe/dadosDaObra/numeroArt
numeroCei=envioLote/NFS_e/infNFSe/dadosDaObra/numeroCei
numeroProj=envioLote/NFS_e/infNFSe/dadosDaObra/numeroProj
numeroMatri=envioLote/NFS_e/infNFSe/dadosDaObra/numeroMatri

; Informações referentes à transportadora
xNomeTrans=envioLote/NFS_e/infNFSe/transportadora/xNomeTrans
xCpfCnpjTrans=envioLote/NFS_e/infNFSe/transportadora/xCpfCnpjTrans
xInscEstTrans=envioLote/NFS_e/infNFSe/transportadora/xInscEstTrans
xPlacaTrans=envioLote/NFS_e/infNFSe/transportadora/xPlacaTrans
xEndTrans=envioLote/NFS_e/infNFSe/transportadora/xEndTrans
cMunTrans=envioLote/NFS_e/infNFSe/transportadora/cMunTrans
xMunTrans=envioLote/NFS_e/infNFSe/transportadora/xMunTrans
xUfTrans=envioLote/NFS_e/infNFSe/transportadora/xUfTrans
cPaisTrans=envioLote/NFS_e/infNFSe/transportadora/cPaisTrans
xPaisTrans=envioLote/NFS_e/infNFSe/transportadora/xPaisTrans
vTipoFreteTrans=envioLote/NFS_e/infNFSe/transportadora/vTipoFreteTrans

; Totais
vServ=envioLote/NFS_e/infNFSe/total/vServ
vRedBCCivil=envioLote/NFS_e/infNFSe/total/vRedBCCivil
vDesc=envioLote/NFS_e/infNFSe/total/vDesc
vtNF=envioLote/NFS_e/infNFSe/total/vtNF
vtLiq=envioLote/NFS_e/infNFSe/total/vtLiq
vtLiqFaturas=envioLote/NFS_e/infNFSe/total/vtLiqFaturas
totalAproxTrib=envioLote/NFS_e/infNFSe/total/totalAproxTrib

; Totais/ret
vRetIR=envioLote/NFS_e/infNFSe/total/Ret/vRetIR
vRetPISPASEP=envioLote/NFS_e/infNFSe/total/Ret/vRetPISPASEP
vRetCOFINS=envioLote/NFS_e/infNFSe/total/Ret/vRetCOFINS
vRetCSLL=envioLote/NFS_e/infNFSe/total/Ret/vRetCSLL
vRetINSS=envioLote/NFS_e/infNFSe/total/Ret/vRetINSS

; Totais/Iss
vBCISS=envioLote/NFS_e/infNFSe/total/ISS/vBCISS
vISS=envioLote/NFS_e/infNFSe/total/ISS/vISS
vBCSTISS=envioLote/NFS_e/infNFSe/total/ISS/vBCSTISS
vSTISS=envioLote/NFS_e/infNFSe/total/ISS/vSTISS

; Informações referentes à det
cServ=envioLote/NFS_e/infNFSe/det/serv/cServ
cLCServ=envioLote/NFS_e/infNFSe/det/serv/cLCServ
xServ=envioLote/NFS_e/infNFSe/det/serv/xServ
localTributacao=envioLote/NFS_e/infNFSe/det/serv/localTributacao
localVerifResServ=envioLote/NFS_e/infNFSe/det/serv/localVerifResServ
uTrib=envioLote/NFS_e/infNFSe/det/serv/uTrib
qTrib=envioLote/NFS_e/infNFSe/det/serv/qTrib
vUnit=envioLote/NFS_e/infNFSe/det/serv/vUnit
vServ=envioLote/NFS_e/infNFSe/det/serv/vServ
vDesc=envioLote/NFS_e/infNFSe/det/serv/vDesc
vBCISS=envioLote/NFS_e/infNFSe/det/serv/vBCISS
pISS=envioLote/NFS_e/infNFSe/det/serv/pISS
vISS=envioLote/NFS_e/infNFSe/det/serv/vISS
vBCINSS=envioLote/NFS_e/infNFSe/det/serv/vBCINSS
pRetINSS=envioLote/NFS_e/infNFSe/det/serv/pRetINSS
vRetINSS=envioLote/NFS_e/infNFSe/det/serv/vRetINSS
vRed=envioLote/NFS_e/infNFSe/det/serv/vRed
vBCRetIR=envioLote/NFS_e/infNFSe/det/serv/vBCRetIR
pRetIR=envioLote/NFS_e/infNFSe/det/serv/pRetIR
vRetIR=envioLote/NFS_e/infNFSe/det/serv/vRetIR
vBCCOFINS=envioLote/NFS_e/infNFSe/det/serv/vBCCOFINS
pRetCOFINS=envioLote/NFS_e/infNFSe/det/serv/pRetCOFINS
vRetCOFINS=envioLote/NFS_e/infNFSe/det/serv/vRetCOFINS
vBCCSLL=envioLote/NFS_e/infNFSe/det/serv/vBCCSLL
pRetCSLL=envioLote/NFS_e/infNFSe/det/serv/pRetCSLL
vRetCSLL=envioLote/NFS_e/infNFSe/det/serv/vRetCSLL
vBCPISPASEP=envioLote/NFS_e/infNFSe/det/serv/vBCPISPASEP
pRetPISPASEP=envioLote/NFS_e/infNFSe/det/serv/pRetPISPASEP
vRetPISPASEP=envioLote/NFS_e/infNFSe/det/serv/vRetPISPASEP
totalAproxTribServ=envioLote/NFS_e/infNFSe/det/serv/totalAproxTribServ
vRedBCST=envioLote/NFS_e/infNFSe/det/ISSST/vRedBCST
vBCST=envioLote/NFS_e/infNFSe/det/ISSST/vBCST
pISSST=envioLote/NFS_e/infNFSe/det/ISSST/pISSST
vISSST=envioLote/NFS_e/infNFSe/det/ISSST/vISSST
nItem=envioLote/NFS_e/infNFSe/det/nItem

; Informações referentes à cobrança
nItem=envioLote/NFS_e/infNFSe/faturas/fat/nItem
nFat=envioLote/NFS_e/infNFSe/faturas/fat/nFat
dVenc=envioLote/NFS_e/infNFSe/faturas/fat/dVenc
vFat=envioLote/NFS_e/infNFSe/faturas/fat/vFat
tipoVencFat=envioLote/NFS_e/infNFSe/faturas/fat/tipoVencFat
descTipoVencFat=envioLote/NFS_e/infNFSe/faturas/fat/descTipoVencFat

; Informações adicionais
infAdicLT=envioLote/NFS_e/infNFSe/infAdicLT
infAdicES=envioLote/NFS_e/infNFSe/infAdicES
infAdic=envioLote/NFS_e/infNFSe/infAdic
infAdicAT=envioLote/NFS_e/infNFSe/infAdicAT
versao=envioLote/NFS_e/infNFSe/@versao

;***************************************************************************************************
;Definições dos Campos: Impressão de NFSe (Impressão Nova)
;***************************************************************************************************
[PrintXml_DadosNFSe]
FILE=MappingImpressaoNFSe.txt

;***************************************************************************************************
;Definições dos Campos: Impressão de RPS (Impressão Nova)
;***************************************************************************************************
[PrintXml_DadosRPS]
FILE=MappingImpressaoRPS.txt

;***************************************************************************************************
;Campos de Configuração da Impressão Nova
;***************************************************************************************************
[PrintXml_Config]
ModoImpressao=String[4]
DiretorioTemplates=String[255]
Titulo=String[80]
BrasaoMunicipio=String[255]
LogotipoEmitente=String[255]
ArquivoMunicipios=String[255]
DebugMode=String[5]
SecretariaResponsavel=String[80]
SubtituloNFSe=String[80]
SubtituloRPS=String[80]
NomeCidade=String[80]
NomePadrao=String[80]
