;***************************************************************************************************
;        ARQUIVO DE MAPEAMENTO PARA O PADRÃO AGILI
;***************************************************************************************************

;***************************************************************************************************
;Configuração do NFSeDataset para Envio de Lote de RPS (Proxy)
;***************************************************************************************************
[ENVIAR]
XSDElementName=GerarNfseEnvio
XSDFile=WebAPI-NFSe.xsd
XSDStartNode=
IgnoredXPaths=GerarNfseEnvio/DeclaracaoPrestacaoServico/IdentificacaoPrestador/Signature
UseNamespacePrefixes=0
XMLHeader=
RootAttributes=

;***************************************************************************************************
;Nomes dos comandos para os respectivos datasets (para uso nos arquivos TX2)
;***************************************************************************************************
[comandos]
GerarNfseEnvio.Insert=INCLUIRRPS
GerarNfseEnvio.Post=SALVARRPS
NotaUsada.Insert=INCLUIRNOTAUSADA
NotaUsada.Post=SALVARNOTAUSADA
ItemUsado.Insert=INCLUIRITEMUSADO
ItemUsado.Post=SALVARITEMUSADO
DadosServico.Insert=INCLUIRSERVICO
DadosServico.Post=SALVARSERVICO

;***************************************************************************************************
;Nomes dos Campos: Envio de Lote de RPS (Proxy)
;***************************************************************************************************
[GerarNfseEnvio]
Versao=GerarNfseEnvio/DeclaracaoPrestacaoServico/Versao
CpfPrestador=GerarNfseEnvio/DeclaracaoPrestacaoServico/IdentificacaoPrestador/CpfCnpj/Cpf
CnpjPrestador=GerarNfseEnvio/DeclaracaoPrestacaoServico/IdentificacaoPrestador/CpfCnpj/Cnpj
InscricaoMunicipalPrestador=GerarNfseEnvio/DeclaracaoPrestacaoServico/IdentificacaoPrestador/InscricaoMunicipal
NfseSubstituida=GerarNfseEnvio/DeclaracaoPrestacaoServico/NfseSubstituida
NumeroRps=GerarNfseEnvio/DeclaracaoPrestacaoServico/Rps/IdentificacaoRps/Numero
SerieRps=GerarNfseEnvio/DeclaracaoPrestacaoServico/Rps/IdentificacaoRps/Serie
TipoRps=GerarNfseEnvio/DeclaracaoPrestacaoServico/Rps/IdentificacaoRps/Tipo
DiscriminacaoRps=GerarNfseEnvio/DeclaracaoPrestacaoServico/Rps/IdentificacaoRps/Descricao
IdentificadorRps=GerarNfseEnvio/DeclaracaoPrestacaoServico/Rps/IdentificacaoRps/Identificador
IdentificadorRpsSubstituido=GerarNfseEnvio/DeclaracaoPrestacaoServico/Rps/IdentificacaoRps/IdentificadorSubstituido
DataEmissao=GerarNfseEnvio/DeclaracaoPrestacaoServico/Rps/DataEmissao
CpfTomador=GerarNfseEnvio/DeclaracaoPrestacaoServico/DadosTomador/IdentificacaoTomador/CpfCnpj/Cpf
CnpjTomador=GerarNfseEnvio/DeclaracaoPrestacaoServico/DadosTomador/IdentificacaoTomador/CpfCnpj/Cnpj
InscricaoMunicipalTomador=GerarNfseEnvio/DeclaracaoPrestacaoServico/DadosTomador/IdentificacaoTomador/InscricaoMunicipal
InscricaoEstadualTomador=GerarNfseEnvio/DeclaracaoPrestacaoServico/DadosTomador/InscricaoEstadual
RazaoSocialTomador=GerarNfseEnvio/DeclaracaoPrestacaoServico/DadosTomador/RazaoSocial
LocalEndereco=GerarNfseEnvio/DeclaracaoPrestacaoServico/DadosTomador/LocalEndereco
TipoLogradouroTomador=GerarNfseEnvio/DeclaracaoPrestacaoServico/DadosTomador/Endereco/TipoLogradouro
LogradouroTomador=GerarNfseEnvio/DeclaracaoPrestacaoServico/DadosTomador/Endereco/Logradouro
NumeroTomador=GerarNfseEnvio/DeclaracaoPrestacaoServico/DadosTomador/Endereco/Numero
ComplementoTomador=GerarNfseEnvio/DeclaracaoPrestacaoServico/DadosTomador/Endereco/Complemento
BairroTomador=GerarNfseEnvio/DeclaracaoPrestacaoServico/DadosTomador/Endereco/Bairro
CodigoMunicipioTomador=GerarNfseEnvio/DeclaracaoPrestacaoServico/DadosTomador/Endereco/Municipio/CodigoMunicipioIBGE
DescricaoCidadeTomador=GerarNfseEnvio/DeclaracaoPrestacaoServico/DadosTomador/Endereco/Municipio/Descricao
UfTomador=GerarNfseEnvio/DeclaracaoPrestacaoServico/DadosTomador/Endereco/Municipio/Uf
PaisTomador=GerarNfseEnvio/DeclaracaoPrestacaoServico/DadosTomador/Endereco/Pais/CodigoPaisBacen
DescricaoPaisTomador=GerarNfseEnvio/DeclaracaoPrestacaoServico/DadosTomador/Endereco/Pais/Descricao
CepTomador=GerarNfseEnvio/DeclaracaoPrestacaoServico/DadosTomador/Endereco/Cep
EnderecoExteriorTomador=GerarNfseEnvio/DeclaracaoPrestacaoServico/DadosTomador/EnderecoExterior/Descricao
CodigoPaisBacenExteriorTomador=GerarNfseEnvio/DeclaracaoPrestacaoServico/DadosTomador/EnderecoExterior/Pais/CodigoPaisBacen
DescricaoPaisExteriorTomador=GerarNfseEnvio/DeclaracaoPrestacaoServico/DadosTomador/EnderecoExterior/Pais/Descricao
TelefoneTomador=GerarNfseEnvio/DeclaracaoPrestacaoServico/DadosTomador/Contato/Telefone
EmailTomador=GerarNfseEnvio/DeclaracaoPrestacaoServico/DadosTomador/Contato/Email
CpfIntermediario=GerarNfseEnvio/DeclaracaoPrestacaoServico/DadosIntermediario/IdentificacaoIntermediario/CpfCnpj/Cpf
CnpjIntermediario=GerarNfseEnvio/DeclaracaoPrestacaoServico/DadosIntermediario/IdentificacaoIntermediario/CpfCnpj/Cnpj
InscricaoMunicipalIntermediario=GerarNfseEnvio/DeclaracaoPrestacaoServico/DadosIntermediario/IdentificacaoIntermediario/InscricaoMunicipal
RazaoSocialIntermediario=GerarNfseEnvio/DeclaracaoPrestacaoServico/DadosIntermediario/RazaoSocial
CodigoObra=GerarNfseEnvio/DeclaracaoPrestacaoServico/DadosMaterialUsado/CodigoObra
Art=GerarNfseEnvio/DeclaracaoPrestacaoServico/DadosMaterialUsado/Art
RegimeEspecialTributacao=GerarNfseEnvio/DeclaracaoPrestacaoServico/RegimeEspecialTributacao/Codigo
DescRegimeEspecialTributacao=GerarNfseEnvio/DeclaracaoPrestacaoServico/RegimeEspecialTributacao/Descricao
OptanteSimplesNacional=GerarNfseEnvio/DeclaracaoPrestacaoServico/OptanteSimplesNacional
OptanteMEISimei=GerarNfseEnvio/DeclaracaoPrestacaoServico/OptanteMEISimei
IssRetido=GerarNfseEnvio/DeclaracaoPrestacaoServico/ISSQNRetido
CodigoResponsavelIss=GerarNfseEnvio/DeclaracaoPrestacaoServico/ResponsavelISSQN/Codigo
DescricaoResponsavelIss=GerarNfseEnvio/DeclaracaoPrestacaoServico/ResponsavelISSQN/Descricao
CodigoItemListaServico=GerarNfseEnvio/DeclaracaoPrestacaoServico/CodigoAtividadeEconomica
ExigibilidadeIss=GerarNfseEnvio/DeclaracaoPrestacaoServico/ExigibilidadeISSQN/Codigo
DescricaoExigibilidadeIss=GerarNfseEnvio/DeclaracaoPrestacaoServico/ExigibilidadeISSQN/Descricao
MunicipioIncidencia=GerarNfseEnvio/DeclaracaoPrestacaoServico/MunicipioIncidencia/CodigoMunicipioIBGE
DescricaoMunicipioIncidencia=GerarNfseEnvio/DeclaracaoPrestacaoServico/MunicipioIncidencia/Descricao
UfMunicipioIncidencia=GerarNfseEnvio/DeclaracaoPrestacaoServico/MunicipioIncidencia/Uf
ValorServicos=GerarNfseEnvio/DeclaracaoPrestacaoServico/ValorServicos
ValorPis=GerarNfseEnvio/DeclaracaoPrestacaoServico/ValorPis
ValorCofins=GerarNfseEnvio/DeclaracaoPrestacaoServico/ValorCofins
ValorInss=GerarNfseEnvio/DeclaracaoPrestacaoServico/ValorInss
ValorIr=GerarNfseEnvio/DeclaracaoPrestacaoServico/ValorIrrf
ValorCsll=GerarNfseEnvio/DeclaracaoPrestacaoServico/ValorCsll
ValorIss=GerarNfseEnvio/DeclaracaoPrestacaoServico/ValorISSQNCalculado
ValorIssRetido=GerarNfseEnvio/DeclaracaoPrestacaoServico/ValorISSQNRecolher
ValorDeducaoConsCivil=GerarNfseEnvio/DeclaracaoPrestacaoServico/ValorDeducaoConstCivil
ValorLiquido=GerarNfseEnvio/DeclaracaoPrestacaoServico/ValorLiquido
ValorDescontos=GerarNfseEnvio/DeclaracaoPrestacaoServico/ValorDescontos
OutrasRetencoes=GerarNfseEnvio/DeclaracaoPrestacaoServico/ValorOutrasRetencoes
BaseCalculo=GerarNfseEnvio/DeclaracaoPrestacaoServico/ValorBaseCalculoISSQN
Aliquota=GerarNfseEnvio/DeclaracaoPrestacaoServico/AliquotaISSQN
TipoAbatimento=GerarNfseEnvio/DeclaracaoPrestacaoServico/TipoAbatimento
PercentualAbatimento=GerarNfseEnvio/DeclaracaoPrestacaoServico/PercAbatimento
Observacao=GerarNfseEnvio/DeclaracaoPrestacaoServico/Observacao
Complemento=GerarNfseEnvio/DeclaracaoPrestacaoServico/Complemento

;Dataset NotaUsada
Cpf=GerarNfseEnvio/DeclaracaoPrestacaoServico/DadosMaterialUsado/ListaNotaUsada/NotaUsada/CpfCnpj/Cpf
Cnpj=GerarNfseEnvio/DeclaracaoPrestacaoServico/DadosMaterialUsado/ListaNotaUsada/NotaUsada/CpfCnpj/Cnpj
NomeFornecedor=GerarNfseEnvio/DeclaracaoPrestacaoServico/DadosMaterialUsado/ListaNotaUsada/NotaUsada/NomeFornecedor
NumeroNF=GerarNfseEnvio/DeclaracaoPrestacaoServico/DadosMaterialUsado/ListaNotaUsada/NotaUsada/NumeroNF
DataNF=GerarNfseEnvio/DeclaracaoPrestacaoServico/DadosMaterialUsado/ListaNotaUsada/NotaUsada/DataNF

;SubDataset ItemUsado
IdItemUsado=GerarNfseEnvio/DeclaracaoPrestacaoServico/DadosMaterialUsado/ListaNotaUsada/NotaUsada/ListaItemUsado/ItemUsado/IdItemUsado
DescricaoItemUsado=GerarNfseEnvio/DeclaracaoPrestacaoServico/DadosMaterialUsado/ListaNotaUsada/NotaUsada/ListaItemUsado/ItemUsado/DescricaoItemUsado
IdUnidadeMedida=GerarNfseEnvio/DeclaracaoPrestacaoServico/DadosMaterialUsado/ListaNotaUsada/NotaUsada/ListaItemUsado/ItemUsado/IdUnidadeMedida
DescricaoUnidadeMedida=GerarNfseEnvio/DeclaracaoPrestacaoServico/DadosMaterialUsado/ListaNotaUsada/NotaUsada/ListaItemUsado/ItemUsado/DescricaoUnidadeMedida
Quantidade=GerarNfseEnvio/DeclaracaoPrestacaoServico/DadosMaterialUsado/ListaNotaUsada/NotaUsada/ListaItemUsado/ItemUsado/Quantidade
ValorTotal=GerarNfseEnvio/DeclaracaoPrestacaoServico/DadosMaterialUsado/ListaNotaUsada/NotaUsada/ListaItemUsado/ItemUsado/ValorTotal

;Dataset DadosServico
Discriminacao=GerarNfseEnvio/DeclaracaoPrestacaoServico/ListaServico/DadosServico/Discriminacao
CodigoCnae=GerarNfseEnvio/DeclaracaoPrestacaoServico/ListaServico/DadosServico/CodigoCnae
ItemListaServico=GerarNfseEnvio/DeclaracaoPrestacaoServico/ListaServico/DadosServico/ItemLei116
Quantidade=GerarNfseEnvio/DeclaracaoPrestacaoServico/ListaServico/DadosServico/Quantidade
ValorServico=GerarNfseEnvio/DeclaracaoPrestacaoServico/ListaServico/DadosServico/ValorServico
ValorDesconto=GerarNfseEnvio/DeclaracaoPrestacaoServico/ListaServico/DadosServico/ValorDesconto

;***************************************************************************************************
;Definições dos Campos: Impressão de NFSe (Impressão Nova)
;***************************************************************************************************
[PrintXml_DadosNFSe]
FILE=MappingImpressaoNFSe.txt

;***************************************************************************************************
;Definições dos Campos: Impressão de RPS (Impressão Nova)
;***************************************************************************************************
[PrintXml_DadosRPS]
FILE=MappingImpressaoRPS.txt

;***************************************************************************************************
;Campos de Configuração da Impressão Nova
;***************************************************************************************************
[PrintXml_Config]
ModoImpressao=String[4]
DiretorioTemplates=String[255]
Titulo=String[80]
BrasaoMunicipio=String[255]
LogotipoEmitente=String[255]
ArquivoMunicipios=String[255]
DebugMode=String[5]
NomeCidade=String[80]
NomePadrao=String[80]
