;***************************************************************************************************
;        ARQUIVO DE MAPEAMENTO PARA O PADRÃO Joinville
;***************************************************************************************************

;***************************************************************************************************
;Configuração do NFSeDataset para Envio de Lote de RPS (Proxy)
;***************************************************************************************************
[ENVIAR]
XSDElementName=EnviarLoteRpsEnvio
XSDFile=nfse v2 02.xsd
XSDStartNode=
IgnoredXPaths=EnviarLoteRpsEnvio/LoteRps/ListaRps/Rps/Signature;EnviarLoteRpsEnvio/Signature
UseNamespacePrefixes=0
XMLHeader=
RootAttributes=

;***************************************************************************************************
;Nomes dos comandos para os respectivos datasets (para uso nos arquivos TX2)
;***************************************************************************************************
[comandos]
EnviarLoteRpsEnvio.Insert=INCLUIR
EnviarLoteRpsEnvio.Post=SALVAR
Rps.Insert=INCLUIRRPS
Rps.Post=SALVARRPS
Deducao.Insert=INCLUIRDEDUCAO
Deducao.Post=SALVARDEDUCAO

;***************************************************************************************************
;Nomes dos Campos: Envio de Lote de RPS (Proxy)
;***************************************************************************************************
[EnviarLoteRpsEnvio]
NumeroLote=EnviarLoteRpsEnvio/LoteRps/NumeroLote
Cpf=EnviarLoteRpsEnvio/LoteRps/Prestador/CpfCnpj/Cpf
Cnpj=EnviarLoteRpsEnvio/LoteRps/Prestador/CpfCnpj/Cnpj
InscricaoMunicipal=EnviarLoteRpsEnvio/LoteRps/Prestador/InscricaoMunicipal
QuantidadeRps=EnviarLoteRpsEnvio/LoteRps/QuantidadeRps
IdLote=EnviarLoteRpsEnvio/LoteRps/@Id
versao=EnviarLoteRpsEnvio/LoteRps/@versao
NumeroRps=EnviarLoteRpsEnvio/LoteRps/ListaRps/Rps/InfDeclaracaoPrestacaoServico/Rps/IdentificacaoRps/Numero
SerieRps=EnviarLoteRpsEnvio/LoteRps/ListaRps/Rps/InfDeclaracaoPrestacaoServico/Rps/IdentificacaoRps/Serie
TipoRps=EnviarLoteRpsEnvio/LoteRps/ListaRps/Rps/InfDeclaracaoPrestacaoServico/Rps/IdentificacaoRps/Tipo
DataEmissao=EnviarLoteRpsEnvio/LoteRps/ListaRps/Rps/InfDeclaracaoPrestacaoServico/Rps/DataEmissao
Status=EnviarLoteRpsEnvio/LoteRps/ListaRps/Rps/InfDeclaracaoPrestacaoServico/Rps/Status
NumeroRpsSubstituido=EnviarLoteRpsEnvio/LoteRps/ListaRps/Rps/InfDeclaracaoPrestacaoServico/Rps/RpsSubstituido/Numero
SerieRpsSubstituido=EnviarLoteRpsEnvio/LoteRps/ListaRps/Rps/InfDeclaracaoPrestacaoServico/Rps/RpsSubstituido/Serie
TipoRpsSubstituido=EnviarLoteRpsEnvio/LoteRps/ListaRps/Rps/InfDeclaracaoPrestacaoServico/Rps/RpsSubstituido/Tipo
IdRps=EnviarLoteRpsEnvio/LoteRps/ListaRps/Rps/InfDeclaracaoPrestacaoServico/Rps/@Id
Competencia=EnviarLoteRpsEnvio/LoteRps/ListaRps/Rps/InfDeclaracaoPrestacaoServico/Competencia
ValorServicos=EnviarLoteRpsEnvio/LoteRps/ListaRps/Rps/InfDeclaracaoPrestacaoServico/Servico/Valores/ValorServicos
ValorDeducoes=EnviarLoteRpsEnvio/LoteRps/ListaRps/Rps/InfDeclaracaoPrestacaoServico/Servico/Valores/ValorDeducoes
ValorPis=EnviarLoteRpsEnvio/LoteRps/ListaRps/Rps/InfDeclaracaoPrestacaoServico/Servico/Valores/ValorPis
ValorCofins=EnviarLoteRpsEnvio/LoteRps/ListaRps/Rps/InfDeclaracaoPrestacaoServico/Servico/Valores/ValorCofins
ValorInss=EnviarLoteRpsEnvio/LoteRps/ListaRps/Rps/InfDeclaracaoPrestacaoServico/Servico/Valores/ValorInss
ValorIr=EnviarLoteRpsEnvio/LoteRps/ListaRps/Rps/InfDeclaracaoPrestacaoServico/Servico/Valores/ValorIr
ValorCsll=EnviarLoteRpsEnvio/LoteRps/ListaRps/Rps/InfDeclaracaoPrestacaoServico/Servico/Valores/ValorCsll
OutrasRetencoes=EnviarLoteRpsEnvio/LoteRps/ListaRps/Rps/InfDeclaracaoPrestacaoServico/Servico/Valores/OutrasRetencoes
ValTotTributos=EnviarLoteRpsEnvio/LoteRps/ListaRps/Rps/InfDeclaracaoPrestacaoServico/Servico/Valores/ValTotTributos
ValorIss=EnviarLoteRpsEnvio/LoteRps/ListaRps/Rps/InfDeclaracaoPrestacaoServico/Servico/Valores/ValorIss
Aliquota=EnviarLoteRpsEnvio/LoteRps/ListaRps/Rps/InfDeclaracaoPrestacaoServico/Servico/Valores/Aliquota
DescontoIncondicionado=EnviarLoteRpsEnvio/LoteRps/ListaRps/Rps/InfDeclaracaoPrestacaoServico/Servico/Valores/DescontoIncondicionado
DescontoCondicionado=EnviarLoteRpsEnvio/LoteRps/ListaRps/Rps/InfDeclaracaoPrestacaoServico/Servico/Valores/DescontoCondicionado
IssRetido=EnviarLoteRpsEnvio/LoteRps/ListaRps/Rps/InfDeclaracaoPrestacaoServico/Servico/IssRetido
ResponsavelRetencao=EnviarLoteRpsEnvio/LoteRps/ListaRps/Rps/InfDeclaracaoPrestacaoServico/Servico/ResponsavelRetencao
ItemListaServico=EnviarLoteRpsEnvio/LoteRps/ListaRps/Rps/InfDeclaracaoPrestacaoServico/Servico/ItemListaServico
CodigoCnae=EnviarLoteRpsEnvio/LoteRps/ListaRps/Rps/InfDeclaracaoPrestacaoServico/Servico/CodigoCnae
CodigoTributacaoMunicipio=EnviarLoteRpsEnvio/LoteRps/ListaRps/Rps/InfDeclaracaoPrestacaoServico/Servico/CodigoTributacaoMunicipio
CodigoNbs=EnviarLoteRpsEnvio/LoteRps/ListaRps/Rps/InfDeclaracaoPrestacaoServico/Servico/CodigoNbs
DiscriminacaoServico=EnviarLoteRpsEnvio/LoteRps/ListaRps/Rps/InfDeclaracaoPrestacaoServico/Servico/Discriminacao
CodigoMunicipio=EnviarLoteRpsEnvio/LoteRps/ListaRps/Rps/InfDeclaracaoPrestacaoServico/Servico/CodigoMunicipio
CodigoPais=EnviarLoteRpsEnvio/LoteRps/ListaRps/Rps/InfDeclaracaoPrestacaoServico/Servico/CodigoPais
ExigibilidadeISS=EnviarLoteRpsEnvio/LoteRps/ListaRps/Rps/InfDeclaracaoPrestacaoServico/Servico/ExigibilidadeISS
IdentifNaoExigibilidade=EnviarLoteRpsEnvio/LoteRps/ListaRps/Rps/InfDeclaracaoPrestacaoServico/Servico/IdentifNaoExigibilidade
MunicipioIncidencia=EnviarLoteRpsEnvio/LoteRps/ListaRps/Rps/InfDeclaracaoPrestacaoServico/Servico/MunicipioIncidencia
NumeroProcesso=EnviarLoteRpsEnvio/LoteRps/ListaRps/Rps/InfDeclaracaoPrestacaoServico/Servico/NumeroProcesso
CpfPrestador=EnviarLoteRpsEnvio/LoteRps/ListaRps/Rps/InfDeclaracaoPrestacaoServico/Prestador/CpfCnpj/Cpf
CnpjPrestador=EnviarLoteRpsEnvio/LoteRps/ListaRps/Rps/InfDeclaracaoPrestacaoServico/Prestador/CpfCnpj/Cnpj
InscricaoMunicipalPrestador=EnviarLoteRpsEnvio/LoteRps/ListaRps/Rps/InfDeclaracaoPrestacaoServico/Prestador/InscricaoMunicipal
CpfTomador=EnviarLoteRpsEnvio/LoteRps/ListaRps/Rps/InfDeclaracaoPrestacaoServico/TomadorServico/IdentificacaoTomador/CpfCnpj/Cpf
CnpjTomador=EnviarLoteRpsEnvio/LoteRps/ListaRps/Rps/InfDeclaracaoPrestacaoServico/TomadorServico/IdentificacaoTomador/CpfCnpj/Cnpj
InscricaoMunicipalTomador=EnviarLoteRpsEnvio/LoteRps/ListaRps/Rps/InfDeclaracaoPrestacaoServico/TomadorServico/IdentificacaoTomador/InscricaoMunicipal
NifTomador=EnviarLoteRpsEnvio/LoteRps/ListaRps/Rps/InfDeclaracaoPrestacaoServico/TomadorServico/NifTomador
RazaoSocialTomador=EnviarLoteRpsEnvio/LoteRps/ListaRps/Rps/InfDeclaracaoPrestacaoServico/TomadorServico/RazaoSocial
EnderecoTomador=EnviarLoteRpsEnvio/LoteRps/ListaRps/Rps/InfDeclaracaoPrestacaoServico/TomadorServico/Endereco/Endereco
NumeroTomador=EnviarLoteRpsEnvio/LoteRps/ListaRps/Rps/InfDeclaracaoPrestacaoServico/TomadorServico/Endereco/Numero
ComplementoTomador=EnviarLoteRpsEnvio/LoteRps/ListaRps/Rps/InfDeclaracaoPrestacaoServico/TomadorServico/Endereco/Complemento
BairroTomador=EnviarLoteRpsEnvio/LoteRps/ListaRps/Rps/InfDeclaracaoPrestacaoServico/TomadorServico/Endereco/Bairro
CodigoMunicipioTomador=EnviarLoteRpsEnvio/LoteRps/ListaRps/Rps/InfDeclaracaoPrestacaoServico/TomadorServico/Endereco/CodigoMunicipio
UfTomador=EnviarLoteRpsEnvio/LoteRps/ListaRps/Rps/InfDeclaracaoPrestacaoServico/TomadorServico/Endereco/Uf
CepTomador=EnviarLoteRpsEnvio/LoteRps/ListaRps/Rps/InfDeclaracaoPrestacaoServico/TomadorServico/Endereco/Cep
CodigoPaisTomador=EnviarLoteRpsEnvio/LoteRps/ListaRps/Rps/InfDeclaracaoPrestacaoServico/TomadorServico/EnderecoExterior/CodigoPais
EnderecoCompletoExterior=EnviarLoteRpsEnvio/LoteRps/ListaRps/Rps/InfDeclaracaoPrestacaoServico/TomadorServico/EnderecoExterior/EnderecoCompletoExterior
TelefoneTomador=EnviarLoteRpsEnvio/LoteRps/ListaRps/Rps/InfDeclaracaoPrestacaoServico/TomadorServico/Contato/Telefone
EmailTomador=EnviarLoteRpsEnvio/LoteRps/ListaRps/Rps/InfDeclaracaoPrestacaoServico/TomadorServico/Contato/Email
CpfIntermediario=EnviarLoteRpsEnvio/LoteRps/ListaRps/Rps/InfDeclaracaoPrestacaoServico/Intermediario/IdentificacaoIntermediario/CpfCnpj/Cpf
CnpjIntermediario=EnviarLoteRpsEnvio/LoteRps/ListaRps/Rps/InfDeclaracaoPrestacaoServico/Intermediario/IdentificacaoIntermediario/CpfCnpj/Cnpj
InscricaoMunicipalIntermediario=EnviarLoteRpsEnvio/LoteRps/ListaRps/Rps/InfDeclaracaoPrestacaoServico/Intermediario/IdentificacaoIntermediario/InscricaoMunicipal
RazaoSocialIntermediario=EnviarLoteRpsEnvio/LoteRps/ListaRps/Rps/InfDeclaracaoPrestacaoServico/Intermediario/RazaoSocial
CodigoMunicipioIntermediario=EnviarLoteRpsEnvio/LoteRps/ListaRps/Rps/InfDeclaracaoPrestacaoServico/Intermediario/CodigoMunicipio
CodigoObra=EnviarLoteRpsEnvio/LoteRps/ListaRps/Rps/InfDeclaracaoPrestacaoServico/ConstrucaoCivil/CodigoObra
Art=EnviarLoteRpsEnvio/LoteRps/ListaRps/Rps/InfDeclaracaoPrestacaoServico/ConstrucaoCivil/Art
RegimeEspecialTributacao=EnviarLoteRpsEnvio/LoteRps/ListaRps/Rps/InfDeclaracaoPrestacaoServico/RegimeEspecialTributacao
OptanteSimplesNacional=EnviarLoteRpsEnvio/LoteRps/ListaRps/Rps/InfDeclaracaoPrestacaoServico/OptanteSimplesNacional
IncentivoFiscal=EnviarLoteRpsEnvio/LoteRps/ListaRps/Rps/InfDeclaracaoPrestacaoServico/IncentivoFiscal
IdentificacaoEvento=EnviarLoteRpsEnvio/LoteRps/ListaRps/Rps/InfDeclaracaoPrestacaoServico/Evento/IdentificacaoEvento
DescricaoEvento=EnviarLoteRpsEnvio/LoteRps/ListaRps/Rps/InfDeclaracaoPrestacaoServico/Evento/DescricaoEvento
InformacoesComplementares=EnviarLoteRpsEnvio/LoteRps/ListaRps/Rps/InfDeclaracaoPrestacaoServico/InformacoesComplementares
IdDeclaracao=EnviarLoteRpsEnvio/LoteRps/ListaRps/Rps/InfDeclaracaoPrestacaoServico/@Id
TipoDeducao=EnviarLoteRpsEnvio/LoteRps/ListaRps/Rps/InfDeclaracaoPrestacaoServico/Deducao/TipoDeducao
DescricaoDeducao=EnviarLoteRpsEnvio/LoteRps/ListaRps/Rps/InfDeclaracaoPrestacaoServico/Deducao/DescricaoDeducao
CodigoMunicipioGerador=EnviarLoteRpsEnvio/LoteRps/ListaRps/Rps/InfDeclaracaoPrestacaoServico/Deducao/IdentificacaoDocumentoDeducao/IdentificacaoNfse/CodigoMunicipioGerador
NumeroNfse=EnviarLoteRpsEnvio/LoteRps/ListaRps/Rps/InfDeclaracaoPrestacaoServico/Deducao/IdentificacaoDocumentoDeducao/IdentificacaoNfse/NumeroNfse
CodigoVerificacao=EnviarLoteRpsEnvio/LoteRps/ListaRps/Rps/InfDeclaracaoPrestacaoServico/Deducao/IdentificacaoDocumentoDeducao/IdentificacaoNfse/CodigoVerificacao
NumeroNfe=EnviarLoteRpsEnvio/LoteRps/ListaRps/Rps/InfDeclaracaoPrestacaoServico/Deducao/IdentificacaoDocumentoDeducao/IdentificacaoNfe/NumeroNfe
UfNfe=EnviarLoteRpsEnvio/LoteRps/ListaRps/Rps/InfDeclaracaoPrestacaoServico/Deducao/IdentificacaoDocumentoDeducao/IdentificacaoNfe/UfNfe
ChaveAcessoNfe=EnviarLoteRpsEnvio/LoteRps/ListaRps/Rps/InfDeclaracaoPrestacaoServico/Deducao/IdentificacaoDocumentoDeducao/IdentificacaoNfe/ChaveAcessoNfe
IdentificacaoDocumento=EnviarLoteRpsEnvio/LoteRps/ListaRps/Rps/InfDeclaracaoPrestacaoServico/Deducao/IdentificacaoDocumentoDeducao/OutroDocumento/IdentificacaoDocumento
Cpf=EnviarLoteRpsEnvio/LoteRps/ListaRps/Rps/InfDeclaracaoPrestacaoServico/Deducao/DadosFornecedor/IdentificacaoFornecedor/CpfCnpj/Cpf
Cnpj=EnviarLoteRpsEnvio/LoteRps/ListaRps/Rps/InfDeclaracaoPrestacaoServico/Deducao/DadosFornecedor/IdentificacaoFornecedor/CpfCnpj/Cnpj
NifFornecedor=EnviarLoteRpsEnvio/LoteRps/ListaRps/Rps/InfDeclaracaoPrestacaoServico/Deducao/DadosFornecedor/FornecedorExterior/NifFornecedor
CodigoPais=EnviarLoteRpsEnvio/LoteRps/ListaRps/Rps/InfDeclaracaoPrestacaoServico/Deducao/DadosFornecedor/FornecedorExterior/CodigoPais
DataEmissao=EnviarLoteRpsEnvio/LoteRps/ListaRps/Rps/InfDeclaracaoPrestacaoServico/Deducao/DataEmissao
ValorDedutivel=EnviarLoteRpsEnvio/LoteRps/ListaRps/Rps/InfDeclaracaoPrestacaoServico/Deducao/ValorDedutivel
ValorUtilizadoDeducao=EnviarLoteRpsEnvio/LoteRps/ListaRps/Rps/InfDeclaracaoPrestacaoServico/Deducao/ValorUtilizadoDeducao

;***************************************************************************************************
;Definições dos Campos: Impressão de NFSe (Impressão Nova)
;***************************************************************************************************
[PrintXml_DadosNFSe]
FILE=MappingImpressaoNFSe.txt

;***************************************************************************************************
;Definições dos Campos: Impressão de RPS (Impressão Nova)
;***************************************************************************************************
[PrintXml_DadosRPS]
FILE=MappingImpressaoRPS.txt

;***************************************************************************************************
;Campos de Configuração da Impressão Nova
;***************************************************************************************************
[PrintXml_Config]
ModoImpressao=String[4]
DiretorioTemplates=String[255]
Titulo=String[80]
BrasaoMunicipio=String[255]
LogotipoEmitente=String[255]
ArquivoMunicipios=String[255]
DebugMode=String[5]
NomeCidade=String[80]
NomePadrao=String[80]
