;***************************************************************************************************
;        ARQUIVO DE MAPEAMENTO PARA CONVERSOR TECNONFSE
;***************************************************************************************************

;***************************************************************************************************
;Configuração do XsdDataset para Envio de Lote de RPS padrão TecnoNFSe
;***************************************************************************************************
[EnviarTecnoNFSe]
XSDElementName=TecnoNFSe
XSDFile=TecnoNFSe_v1.xsd

;***************************************************************************************************
;Nomes dos comandos para os respectivos datasets (para uso nos arquivos TX2 padrão TecnoNFSe)
;***************************************************************************************************
[comandos]
TecnoNFSe.Insert=INCLUIR
TecnoNFSe.Post=SALVAR
Rps.Insert=INCLUIRRPS
Rps.Post=SALVARRPS
Servico.Insert=INCLUIRSERVICO
Servico.Post=SALVARSERVICO

;***************************************************************************************************
;Nomes dos Campos: Envio de Lote de RPS padrão TecnoNFSe
;***************************************************************************************************
[TecnoNFSe]
IdLote=TecnoNFSe/IdLote
NumeroLote=TecnoNFSe/NumeroLote
CpfCnpjRemetente=TecnoNFSe/CpfCnpjRemetente
InscricaoMunicipalRemetente=TecnoNFSe/InscricaoMunicipalRemetente
RazaoSocialRemetente=TecnoNFSe/RazaoSocialRemetente
QuantidadeRps=TecnoNFSe/QuantidadeRps
CodigoCidadeRemetente=TecnoNFSe/CodigoCidadeRemetente
Transacao=TecnoNFSe/Transacao
DataInicio=TecnoNFSe/DataInicio
DataFim=TecnoNFSe/DataFim
Versao=TecnoNFSe/Versao
MetodoEnvio=TecnoNFSe/MetodoEnvio
ValorTotalServicos=TecnoNFSe/ValorTotalServicos
ValorTotalDeducoes=TecnoNFSe/ValorTotalDeducoes
ValorTotalBaseCalculo=TecnoNFSe/ValorTotalBaseCalculo

IdRps=TecnoNFSe/Rps/IdRps
NumeroRps=TecnoNFSe/Rps/NumeroRps
SerieRps=TecnoNFSe/Rps/SerieRps
TipoRps=TecnoNFSe/Rps/TipoRps
DataEmissao=TecnoNFSe/Rps/DataEmissao
OptanteSimplesNacional=TecnoNFSe/Rps/OptanteSimplesNacional
IncentivadorCultural=TecnoNFSe/Rps/IncentivadorCultural
SituacaoNota=TecnoNFSe/Rps/SituacaoNota
TipoTributacao=TecnoNFSe/Rps/TipoTributacao
NaturezaTributacao=TecnoNFSe/Rps/NaturezaTributacao
RegimeEspecialTributacao=TecnoNFSe/Rps/RegimeEspecialTributacao
NumeroRpsSubstituido=TecnoNFSe/Rps/NumeroRpsSubstituido
SerieRpsSubstituido=TecnoNFSe/Rps/SerieRpsSubstituido
TipoRpsSubstituido=TecnoNFSe/Rps/TipoRpsSubstituido
ValorServicos=TecnoNFSe/Rps/ValorServicos
ValorDeducoes=TecnoNFSe/Rps/ValorDeducoes
ValorPis=TecnoNFSe/Rps/ValorPis
ValorCofins=TecnoNFSe/Rps/ValorCofins
ValorInss=TecnoNFSe/Rps/ValorInss
ValorIr=TecnoNFSe/Rps/ValorIr
ValorCsll=TecnoNFSe/Rps/ValorCsll
IssRetido=TecnoNFSe/Rps/IssRetido
ValorIss=TecnoNFSe/Rps/ValorIss
ValorIssRetido=TecnoNFSe/Rps/ValorIssRetido
OutrasRetencoes=TecnoNFSe/Rps/OutrasRetencoes
BaseCalculo=TecnoNFSe/Rps/BaseCalculo
ValorLiquidoNfse=TecnoNFSe/Rps/ValorLiquidoNfse
DescontoIncondicionado=TecnoNFSe/Rps/DescontoIncondicionado
DescontoCondicionado=TecnoNFSe/Rps/DescontoCondicionado
AliquotaISS=TecnoNFSe/Rps/AliquotaISS
AliquotaPIS=TecnoNFSe/Rps/AliquotaPIS
AliquotaCOFINS=TecnoNFSe/Rps/AliquotaCOFINS
AliquotaINSS=TecnoNFSe/Rps/AliquotaINSS
AliquotaIR=TecnoNFSe/Rps/AliquotaIR
AliquotaCSLL=TecnoNFSe/Rps/AliquotaCSLL
CodigoItemListaServico=TecnoNFSe/Rps/CodigoItemListaServico
CodigoCnae=TecnoNFSe/Rps/CodigoCnae
CodigoTributacaoMunicipio=TecnoNFSe/Rps/CodigoTributacaoMunicipio
DiscriminacaoServico=TecnoNFSe/Rps/DiscriminacaoServico
ValorCargaTributaria=TecnoNFSe/Rps/ValorCargaTributaria
PercentualCargaTributaria=TecnoNFSe/Rps/PercentualCargaTributaria
FonteCargaTributaria=TecnoNFSe/Rps/FonteCargaTributaria
CodigoCidadePrestacao=TecnoNFSe/Rps/CodigoCidadePrestacao
DescricaoCidadePrestacao=TecnoNFSe/Rps/DescricaoCidadePrestacao
CpfCnpjPrestador=TecnoNFSe/Rps/CpfCnpjPrestador
InscricaoMunicipalPrestador=TecnoNFSe/Rps/InscricaoMunicipalPrestador
RazaoSocialPrestador=TecnoNFSe/Rps/RazaoSocialPrestador
DDDPrestador=TecnoNFSe/Rps/DDDPrestador
TelefonePrestador=TecnoNFSe/Rps/TelefonePrestador
CepPrestador=TecnoNFSe/Rps/CepPrestador
EnderecoPrestador=TecnoNFSe/Rps/EnderecoPrestador
CpfCnpjTomador=TecnoNFSe/Rps/CpfCnpjTomador
RazaoSocialTomador=TecnoNFSe/Rps/RazaoSocialTomador
InscricaoMunicipalTomador=TecnoNFSe/Rps/InscricaoMunicipalTomador
InscricaoEstadualTomador=TecnoNFSe/Rps/InscricaoEstadualTomador
DocTomadorEstrangeiro=TecnoNFSe/Rps/DocTomadorEstrangeiro
TipoLogradouroTomador=TecnoNFSe/Rps/TipoLogradouroTomador
EnderecoTomador=TecnoNFSe/Rps/EnderecoTomador
NumeroTomador=TecnoNFSe/Rps/NumeroTomador
ComplementoTomador=TecnoNFSe/Rps/ComplementoTomador
TipoBairroTomador=TecnoNFSe/Rps/TipoBairroTomador
BairroTomador=TecnoNFSe/Rps/BairroTomador
CodigoCidadeTomador=TecnoNFSe/Rps/CodigoCidadeTomador
DescricaoCidadeTomador=TecnoNFSe/Rps/DescricaoCidadeTomador
UfTomador=TecnoNFSe/Rps/UfTomador
CepTomador=TecnoNFSe/Rps/CepTomador
DDDTomador=TecnoNFSe/Rps/DDDTomador
TelefoneTomador=TecnoNFSe/Rps/TelefoneTomador
TipoTelefoneTomador=TecnoNFSe/Rps/TipoTelefoneTomador
EmailTomador=TecnoNFSe/Rps/EmailTomador
RazaoSocialIntermediario=TecnoNFSe/Rps/RazaoSocialIntermediario
CpfCnpjIntermediario=TecnoNFSe/Rps/CpfCnpjIntermediario
InscricaoMunicipalIntermediario=TecnoNFSe/Rps/InscricaoMunicipalIntermediario
NumeroNfseSubstituida=TecnoNFSe/Rps/NumeroNfseSubstituida
DataEmissaoNfseSubstituida=TecnoNFSe/Rps/DataEmissaoNfseSubstituida
SeriePrestacao=TecnoNFSe/Rps/SeriePrestacao
MotCancelamento=TecnoNFSe/Rps/MotCancelamento
Operacao=TecnoNFSe/Rps/Operacao
CodigoCEI=TecnoNFSe/Rps/CodigoCEI
CodigoObra=TecnoNFSe/Rps/CodigoObra
Art=TecnoNFSe/Rps/Art
DeducaoPor=TecnoNFSe/Rps/DeducaoPor
TipoDeducao=TecnoNFSe/Rps/TipoDeducao
CpfCnpjReferencia=TecnoNFSe/Rps/CpfCnpjReferencia
NumeroNFReferencia=TecnoNFSe/Rps/NumeroNFReferencia
ValorTotalReferencia=TecnoNFSe/Rps/ValorTotalReferencia
PercentualDeduzir=TecnoNFSe/Rps/PercentualDeduzir
DescricaoRPS=TecnoNFSe/Rps/DescricaoRPS
QuantidadeServicos=TecnoNFSe/Rps/QuantidadeServicos
ValorUnitarioServico=TecnoNFSe/Rps/ValorUnitarioServico
Tributavel=TecnoNFSe/Rps/Tributavel
IdentificadorSistemaLegado=TecnoNFSe/Rps/IdentificadorSistemaLegado
TipoCodificacao=TecnoNFSe/Rps/TipoCodificacao
Assinatura=TecnoNFSe/Rps/Assinatura
NumEmissorRps=TecnoNFSe/Rps/NumEmissorRps
TipoDocumentoTomador=TecnoNFSe/Rps/TipoDocumentoTomador
DescricaoDocumentoTomador=TecnoNFSe/Rps/DescricaoDocumentoTomador
CidadeEstrangeiraTomador=TecnoNFSe/Rps/CidadeEstrangeiraTomador
PaisTomador=TecnoNFSe/Rps/PaisTomador
CodigoSubItemListaServico=TecnoNFSe/Rps/CodigoSubItemListaServico
JustificativaDeducao=TecnoNFSe/Rps/JustificativaDeducao
ValorIssServico=TecnoNFSe/Rps/ValorIssServico
IncentivoFiscal=TecnoNFSe/Rps/IncentivoFiscal
Competencia=TecnoNFSe/Rps/Competencia
MunicipioIncidencia=TecnoNFSe/Rps/MunicipioIncidencia
ExigibilidadeISS=TecnoNFSe/Rps/ExigibilidadeISS
CodigoPais=TecnoNFSe/Rps/CodigoPais
ResponsavelRetencao=TecnoNFSe/Rps/ResponsavelRetencao
NumeroNfse=TecnoNFSe/Rps/NumeroNfse
SerieNfse=TecnoNFSe/Rps/SerieNfse
DataEmissaoNfse=TecnoNFSe/Rps/DataEmissaoNfse
TipoLogradouroPrestador=TecnoNFSe/Rps/TipoLogradouroPrestador
NumeroPrestador=TecnoNFSe/Rps/NumeroPrestador
ComplementoPrestador=TecnoNFSe/Rps/ComplementoPrestador
BairroPrestador=TecnoNFSe/Rps/BairroPrestador
CodigoCidadePrestador=TecnoNFSe/Rps/CodigoCidadePrestador
EmailPrestador=TecnoNFSe/Rps/EmailPrestador
InscricaoEstadualPrestador=TecnoNFSe/Rps/InscricaoEstadualPrestador
TipoBairroPrestador=TecnoNFSe/Rps/TipoBairroPrestador
DescricaoCidadePrestador=TecnoNFSe/Rps/DescricaoCidadePrestador
NomeFantasiaPrestador=TecnoNFSe/Rps/NomeFantasiaPrestador
AliquotaSimplesNacional=TecnoNFSe/Rps/AliquotaSimplesNacional

;Dados Servico
ValorUnitarioServico=TecnoNFSe/Rps/Servico/ValorUnitarioServico
DiscriminacaoServico=TecnoNFSe/Rps/Servico/DiscriminacaoServico
QuantidadeServicos=TecnoNFSe/Rps/Servico/QuantidadeServicos
UnidadeServico=TecnoNFSe/Rps/Servico/UnidadeServico
ValorServicos=TecnoNFSe/Rps/Servico/ValorServicos
ValorLiquidoServico=TecnoNFSe/Rps/Servico/ValorLiquidoServico
Tributavel=TecnoNFSe/Rps/Servico/Tributavel
CodigoItemListaServico=TecnoNFSe/Rps/Servico/CodigoItemListaServico
TipoDeducao=TecnoNFSe/Rps/Servico/TipoDeducao
CodigoCnae=TecnoNFSe/Rps/Servico/CodigoCnae
ValorIss=TecnoNFSe/Rps/Servico/ValorIss
CodigoCidadePrestacao=TecnoNFSe/Rps/Servico/CodigoCidadePrestacao
AliquotaServico=TecnoNFSe/Rps/Servico/AliquotaServico
BaseCalculo=TecnoNFSe/Rps/Servico/BaseCalculo