;***************************************************************************************************
;        ARQUIVO DE MAPEAMENTO PARA O PADRÃO MAISISS
;***************************************************************************************************

;***************************************************************************************************
;Configuração do NFSeDataset para Envio de Lote de RPS (Comandos)
;***************************************************************************************************
[XMLENVIO]
XSDElementName=EnviarLoteRpsEnvio
XSDFile=nfse_v1_2.xsd
XSDStartNode=
IgnoredXPaths=EnviarLoteRpsEnvio/Signature;EnviarLoteRpsEnvio/LoteRps/ListaRps/Rps/Signature
UseNamespacePrefixes=0
XMLHeader=
RootAttributes=

;***************************************************************************************************
;Configuração do NFSeDataset para Envio de Lote de RPS (Proxy)
;***************************************************************************************************
[ENVIAR]
XSDElementName=EnviarLoteRpsEnvio
XSDFile=nfse_v1_2.xsd
XSDStartNode=
IgnoredXPaths=EnviarLoteRpsEnvio/Signature;EnviarLoteRpsEnvio/LoteRps/ListaRps/Rps/Signature
UseNamespacePrefixes=0
XMLHeader=
RootAttributes=

;***************************************************************************************************
;Nomes dos comandos para os respectivos datasets (para uso nos arquivos TX2)
;***************************************************************************************************
[comandos]
EnviarLoteRpsEnvio.Insert=INCLUIR
EnviarLoteRpsEnvio.Post=SALVAR
DeclaracaoPrestacaoServico.Insert=INCLUIRRPS
DeclaracaoPrestacaoServico.Post=SALVARRPS
ItemServico.Insert=INCLUIRSERVICO
ItemServico.Post=SALVARSERVICO

;***************************************************************************************************
;Nomes dos Campos: Envio de Lote de RPS (Proxy)
;***************************************************************************************************
[EnviarLoteRpsEnvio]
NumeroLote=EnviarLoteRpsEnvio/LoteRps/NumeroLote
QuantidadeRps=EnviarLoteRpsEnvio/LoteRps/QuantidadeRps
Cpf=EnviarLoteRpsEnvio/IdentificacaoRequerente/CpfCnpj/Cpf
Cnpj=EnviarLoteRpsEnvio/IdentificacaoRequerente/CpfCnpj/Cnpj
InscricaoMunicipal=EnviarLoteRpsEnvio/IdentificacaoRequerente/InscricaoMunicipal
Senha=EnviarLoteRpsEnvio/IdentificacaoRequerente/Senha
Homologa=EnviarLoteRpsEnvio/IdentificacaoRequerente/Homologa
NumeroLote=EnviarLoteRpsEnvio/LoteRps/NumeroLote
QuantidadeRps=EnviarLoteRpsEnvio/LoteRps/QuantidadeRps
NumeroRps=EnviarLoteRpsEnvio/LoteRps/ListaRps/DeclaracaoPrestacaoServico/InfDeclaracaoPrestacaoServico/Rps/IdentificacaoRps/Numero
SerieRps=EnviarLoteRpsEnvio/LoteRps/ListaRps/DeclaracaoPrestacaoServico/InfDeclaracaoPrestacaoServico/Rps/IdentificacaoRps/Serie
TipoRps=EnviarLoteRpsEnvio/LoteRps/ListaRps/DeclaracaoPrestacaoServico/InfDeclaracaoPrestacaoServico/Rps/IdentificacaoRps/Tipo
DataEmissao=EnviarLoteRpsEnvio/LoteRps/ListaRps/DeclaracaoPrestacaoServico/InfDeclaracaoPrestacaoServico/Rps/DataEmissao
Status=EnviarLoteRpsEnvio/LoteRps/ListaRps/DeclaracaoPrestacaoServico/InfDeclaracaoPrestacaoServico/Rps/Status
NumeroRpsSubstituido=EnviarLoteRpsEnvio/LoteRps/ListaRps/DeclaracaoPrestacaoServico/InfDeclaracaoPrestacaoServico/Rps/RpsSubstituido/Numero
SerieRpsSubstituido=EnviarLoteRpsEnvio/LoteRps/ListaRps/DeclaracaoPrestacaoServico/InfDeclaracaoPrestacaoServico/Rps/RpsSubstituido/Serie
TipoRpsSubstituido=EnviarLoteRpsEnvio/LoteRps/ListaRps/DeclaracaoPrestacaoServico/InfDeclaracaoPrestacaoServico/Rps/RpsSubstituido/Tipo
Competencia=EnviarLoteRpsEnvio/LoteRps/ListaRps/DeclaracaoPrestacaoServico/InfDeclaracaoPrestacaoServico/Competencia
ValorServicos=EnviarLoteRpsEnvio/LoteRps/ListaRps/DeclaracaoPrestacaoServico/InfDeclaracaoPrestacaoServico/Servico/Valores/ValorServicos
ValorDeducoes=EnviarLoteRpsEnvio/LoteRps/ListaRps/DeclaracaoPrestacaoServico/InfDeclaracaoPrestacaoServico/Servico/Valores/ValorDeducoes
ValorPis=EnviarLoteRpsEnvio/LoteRps/ListaRps/DeclaracaoPrestacaoServico/InfDeclaracaoPrestacaoServico/Servico/Valores/ValorPis
ValorCofins=EnviarLoteRpsEnvio/LoteRps/ListaRps/DeclaracaoPrestacaoServico/InfDeclaracaoPrestacaoServico/Servico/Valores/ValorCofins
ValorInss=EnviarLoteRpsEnvio/LoteRps/ListaRps/DeclaracaoPrestacaoServico/InfDeclaracaoPrestacaoServico/Servico/Valores/ValorInss
ValorIr=EnviarLoteRpsEnvio/LoteRps/ListaRps/DeclaracaoPrestacaoServico/InfDeclaracaoPrestacaoServico/Servico/Valores/ValorIr
ValorCsll=EnviarLoteRpsEnvio/LoteRps/ListaRps/DeclaracaoPrestacaoServico/InfDeclaracaoPrestacaoServico/Servico/Valores/ValorCsll
OutrasRetencoes=EnviarLoteRpsEnvio/LoteRps/ListaRps/DeclaracaoPrestacaoServico/InfDeclaracaoPrestacaoServico/Servico/Valores/OutrasRetencoes
ValorIss=EnviarLoteRpsEnvio/LoteRps/ListaRps/DeclaracaoPrestacaoServico/InfDeclaracaoPrestacaoServico/Servico/Valores/ValorIss
Aliquota=EnviarLoteRpsEnvio/LoteRps/ListaRps/DeclaracaoPrestacaoServico/InfDeclaracaoPrestacaoServico/Servico/Valores/Aliquota
DescontoIncondicionado=EnviarLoteRpsEnvio/LoteRps/ListaRps/DeclaracaoPrestacaoServico/InfDeclaracaoPrestacaoServico/Servico/Valores/DescontoIncondicionado
DescontoCondicionado=EnviarLoteRpsEnvio/LoteRps/ListaRps/DeclaracaoPrestacaoServico/InfDeclaracaoPrestacaoServico/Servico/Valores/DescontoCondicionado
IssRetido=EnviarLoteRpsEnvio/LoteRps/ListaRps/DeclaracaoPrestacaoServico/InfDeclaracaoPrestacaoServico/Servico/IssRetido
ResponsavelRetencao=EnviarLoteRpsEnvio/LoteRps/ListaRps/DeclaracaoPrestacaoServico/InfDeclaracaoPrestacaoServico/Servico/ResponsavelRetencao
Discriminacao=EnviarLoteRpsEnvio/LoteRps/ListaRps/DeclaracaoPrestacaoServico/InfDeclaracaoPrestacaoServico/Servico/Discriminacao
CodigoMunicipio=EnviarLoteRpsEnvio/LoteRps/ListaRps/DeclaracaoPrestacaoServico/InfDeclaracaoPrestacaoServico/Servico/CodigoMunicipio
CodigoPais=EnviarLoteRpsEnvio/LoteRps/ListaRps/DeclaracaoPrestacaoServico/InfDeclaracaoPrestacaoServico/Servico/CodigoPais
ExigibilidadeISS=EnviarLoteRpsEnvio/LoteRps/ListaRps/DeclaracaoPrestacaoServico/InfDeclaracaoPrestacaoServico/Servico/ExigibilidadeISS
MunicipioIncidencia=EnviarLoteRpsEnvio/LoteRps/ListaRps/DeclaracaoPrestacaoServico/InfDeclaracaoPrestacaoServico/Servico/MunicipioIncidencia
NumeroProcesso=EnviarLoteRpsEnvio/LoteRps/ListaRps/DeclaracaoPrestacaoServico/InfDeclaracaoPrestacaoServico/Servico/NumeroProcesso
CpfPrestador=EnviarLoteRpsEnvio/LoteRps/ListaRps/DeclaracaoPrestacaoServico/InfDeclaracaoPrestacaoServico/DadosPrestador/IdentificacaoPrestador/CpfCnpj/Cpf
CnpjPrestador=EnviarLoteRpsEnvio/LoteRps/ListaRps/DeclaracaoPrestacaoServico/InfDeclaracaoPrestacaoServico/DadosPrestador/IdentificacaoPrestador/CpfCnpj/Cnpj
InscricaoMunicipalPrestador=EnviarLoteRpsEnvio/LoteRps/ListaRps/DeclaracaoPrestacaoServico/InfDeclaracaoPrestacaoServico/DadosPrestador/IdentificacaoPrestador/InscricaoMunicipal
RazaoSocialPrestador=EnviarLoteRpsEnvio/LoteRps/ListaRps/DeclaracaoPrestacaoServico/InfDeclaracaoPrestacaoServico/DadosPrestador/RazaoSocial
NomeFantasiaPrestador=EnviarLoteRpsEnvio/LoteRps/ListaRps/DeclaracaoPrestacaoServico/InfDeclaracaoPrestacaoServico/DadosPrestador/NomeFantasia
EnderecoPrestador=EnviarLoteRpsEnvio/LoteRps/ListaRps/DeclaracaoPrestacaoServico/InfDeclaracaoPrestacaoServico/DadosPrestador/Endereco/Endereco
NumeroPrestador=EnviarLoteRpsEnvio/LoteRps/ListaRps/DeclaracaoPrestacaoServico/InfDeclaracaoPrestacaoServico/DadosPrestador/Endereco/Numero
ComplementoPrestador=EnviarLoteRpsEnvio/LoteRps/ListaRps/DeclaracaoPrestacaoServico/InfDeclaracaoPrestacaoServico/DadosPrestador/Endereco/Complemento
BairroPrestador=EnviarLoteRpsEnvio/LoteRps/ListaRps/DeclaracaoPrestacaoServico/InfDeclaracaoPrestacaoServico/DadosPrestador/Endereco/Bairro
CodigoMunicipioPrestador=EnviarLoteRpsEnvio/LoteRps/ListaRps/DeclaracaoPrestacaoServico/InfDeclaracaoPrestacaoServico/DadosPrestador/Endereco/CodigoMunicipio
CidadeNomePrestador=EnviarLoteRpsEnvio/LoteRps/ListaRps/DeclaracaoPrestacaoServico/InfDeclaracaoPrestacaoServico/DadosPrestador/Endereco/CidadeNome
UfPrestador=EnviarLoteRpsEnvio/LoteRps/ListaRps/DeclaracaoPrestacaoServico/InfDeclaracaoPrestacaoServico/DadosPrestador/Endereco/Uf
CodigoPaisPrestador=EnviarLoteRpsEnvio/LoteRps/ListaRps/DeclaracaoPrestacaoServico/InfDeclaracaoPrestacaoServico/DadosPrestador/Endereco/CodigoPais
CepPrestador=EnviarLoteRpsEnvio/LoteRps/ListaRps/DeclaracaoPrestacaoServico/InfDeclaracaoPrestacaoServico/DadosPrestador/Endereco/Cep
TelefonePrestador=EnviarLoteRpsEnvio/LoteRps/ListaRps/DeclaracaoPrestacaoServico/InfDeclaracaoPrestacaoServico/DadosPrestador/Contato/Telefone
EmailPrestador=EnviarLoteRpsEnvio/LoteRps/ListaRps/DeclaracaoPrestacaoServico/InfDeclaracaoPrestacaoServico/DadosPrestador/Contato/Email
CpfTomador=EnviarLoteRpsEnvio/LoteRps/ListaRps/DeclaracaoPrestacaoServico/InfDeclaracaoPrestacaoServico/Tomador/IdentificacaoTomador/CpfCnpj/Cpf
CnpjTomador=EnviarLoteRpsEnvio/LoteRps/ListaRps/DeclaracaoPrestacaoServico/InfDeclaracaoPrestacaoServico/Tomador/IdentificacaoTomador/CpfCnpj/Cnpj
InscricaoMunicipalTomador=EnviarLoteRpsEnvio/LoteRps/ListaRps/DeclaracaoPrestacaoServico/InfDeclaracaoPrestacaoServico/Tomador/IdentificacaoTomador/InscricaoMunicipal
RazaoSocialTomador=EnviarLoteRpsEnvio/LoteRps/ListaRps/DeclaracaoPrestacaoServico/InfDeclaracaoPrestacaoServico/Tomador/RazaoSocial
EnderecoTomador=EnviarLoteRpsEnvio/LoteRps/ListaRps/DeclaracaoPrestacaoServico/InfDeclaracaoPrestacaoServico/Tomador/Endereco/Endereco
NumeroTomador=EnviarLoteRpsEnvio/LoteRps/ListaRps/DeclaracaoPrestacaoServico/InfDeclaracaoPrestacaoServico/Tomador/Endereco/Numero
ComplementoTomador=EnviarLoteRpsEnvio/LoteRps/ListaRps/DeclaracaoPrestacaoServico/InfDeclaracaoPrestacaoServico/Tomador/Endereco/Complemento
BairroTomador=EnviarLoteRpsEnvio/LoteRps/ListaRps/DeclaracaoPrestacaoServico/InfDeclaracaoPrestacaoServico/Tomador/Endereco/Bairro
CodigoMunicipioTomador=EnviarLoteRpsEnvio/LoteRps/ListaRps/DeclaracaoPrestacaoServico/InfDeclaracaoPrestacaoServico/Tomador/Endereco/CodigoMunicipio
CidadeNomeTomador=EnviarLoteRpsEnvio/LoteRps/ListaRps/DeclaracaoPrestacaoServico/InfDeclaracaoPrestacaoServico/Tomador/Endereco/CidadeNome
UfTomador=EnviarLoteRpsEnvio/LoteRps/ListaRps/DeclaracaoPrestacaoServico/InfDeclaracaoPrestacaoServico/Tomador/Endereco/Uf
CodigoPaisTomador=EnviarLoteRpsEnvio/LoteRps/ListaRps/DeclaracaoPrestacaoServico/InfDeclaracaoPrestacaoServico/Tomador/Endereco/CodigoPais
CepTomador=EnviarLoteRpsEnvio/LoteRps/ListaRps/DeclaracaoPrestacaoServico/InfDeclaracaoPrestacaoServico/Tomador/Endereco/Cep
TelefoneTomador=EnviarLoteRpsEnvio/LoteRps/ListaRps/DeclaracaoPrestacaoServico/InfDeclaracaoPrestacaoServico/Tomador/Contato/Telefone
EmailTomador=EnviarLoteRpsEnvio/LoteRps/ListaRps/DeclaracaoPrestacaoServico/InfDeclaracaoPrestacaoServico/Tomador/Contato/Email
InscricaoEstadualTomador=EnviarLoteRpsEnvio/LoteRps/ListaRps/DeclaracaoPrestacaoServico/InfDeclaracaoPrestacaoServico/Tomador/InscricaoEstadual
CpfIntermediario=EnviarLoteRpsEnvio/LoteRps/ListaRps/DeclaracaoPrestacaoServico/InfDeclaracaoPrestacaoServico/Intermediario/IdentificacaoIntermediario/CpfCnpj/Cpf
CnpjIntermediario=EnviarLoteRpsEnvio/LoteRps/ListaRps/DeclaracaoPrestacaoServico/InfDeclaracaoPrestacaoServico/Intermediario/IdentificacaoIntermediario/CpfCnpj/Cnpj
InscricaoMunicipalIntermediario=EnviarLoteRpsEnvio/LoteRps/ListaRps/DeclaracaoPrestacaoServico/InfDeclaracaoPrestacaoServico/Intermediario/IdentificacaoIntermediario/InscricaoMunicipal
RazaoSocialIntermediario=EnviarLoteRpsEnvio/LoteRps/ListaRps/DeclaracaoPrestacaoServico/InfDeclaracaoPrestacaoServico/Intermediario/RazaoSocial
CodigoObra=EnviarLoteRpsEnvio/LoteRps/ListaRps/DeclaracaoPrestacaoServico/InfDeclaracaoPrestacaoServico/ConstrucaoCivil/CodigoObra
Art=EnviarLoteRpsEnvio/LoteRps/ListaRps/DeclaracaoPrestacaoServico/InfDeclaracaoPrestacaoServico/ConstrucaoCivil/Art
Incorporacao=EnviarLoteRpsEnvio/LoteRps/ListaRps/DeclaracaoPrestacaoServico/InfDeclaracaoPrestacaoServico/ConstrucaoCivil/Incorporacao
RegimeEspecialTributacao=EnviarLoteRpsEnvio/LoteRps/ListaRps/DeclaracaoPrestacaoServico/InfDeclaracaoPrestacaoServico/RegimeEspecialTributacao
IncentivoFiscal=EnviarLoteRpsEnvio/LoteRps/ListaRps/DeclaracaoPrestacaoServico/InfDeclaracaoPrestacaoServico/IncentivoFiscal
ItemListaServico=EnviarLoteRpsEnvio/LoteRps/ListaRps/DeclaracaoPrestacaoServico/InfDeclaracaoPrestacaoServico/Servico/ListaItensServico/ItemServico/ItemListaServico
CodigoCnae=EnviarLoteRpsEnvio/LoteRps/ListaRps/DeclaracaoPrestacaoServico/InfDeclaracaoPrestacaoServico/Servico/ListaItensServico/ItemServico/CodigoCnae
Descricao=EnviarLoteRpsEnvio/LoteRps/ListaRps/DeclaracaoPrestacaoServico/InfDeclaracaoPrestacaoServico/Servico/ListaItensServico/ItemServico/Descricao
Tributavel=EnviarLoteRpsEnvio/LoteRps/ListaRps/DeclaracaoPrestacaoServico/InfDeclaracaoPrestacaoServico/Servico/ListaItensServico/ItemServico/Tributavel
Quantidade=EnviarLoteRpsEnvio/LoteRps/ListaRps/DeclaracaoPrestacaoServico/InfDeclaracaoPrestacaoServico/Servico/ListaItensServico/ItemServico/Quantidade
ValorUnitario=EnviarLoteRpsEnvio/LoteRps/ListaRps/DeclaracaoPrestacaoServico/InfDeclaracaoPrestacaoServico/Servico/ListaItensServico/ItemServico/ValorUnitario
ValorDesconto=EnviarLoteRpsEnvio/LoteRps/ListaRps/DeclaracaoPrestacaoServico/InfDeclaracaoPrestacaoServico/Servico/ListaItensServico/ItemServico/ValorDesconto
ValorLiquido=EnviarLoteRpsEnvio/LoteRps/ListaRps/DeclaracaoPrestacaoServico/InfDeclaracaoPrestacaoServico/Servico/ListaItensServico/ItemServico/ValorLiquido
TipoDeducao=EnviarLoteRpsEnvio/LoteRps/ListaRps/DeclaracaoPrestacaoServico/InfDeclaracaoPrestacaoServico/Servico/ListaItensServico/ItemServico/DadosDeducao/TipoDeducao
CpfDeducao=EnviarLoteRpsEnvio/LoteRps/ListaRps/DeclaracaoPrestacaoServico/InfDeclaracaoPrestacaoServico/Servico/ListaItensServico/ItemServico/DadosDeducao/Cpf
CnpjDeducao=EnviarLoteRpsEnvio/LoteRps/ListaRps/DeclaracaoPrestacaoServico/InfDeclaracaoPrestacaoServico/Servico/ListaItensServico/ItemServico/DadosDeducao/Cnpj
NumeroNotaFiscalReferencia=EnviarLoteRpsEnvio/LoteRps/ListaRps/DeclaracaoPrestacaoServico/InfDeclaracaoPrestacaoServico/Servico/ListaItensServico/ItemServico/DadosDeducao/NumeroNotaFiscalReferencia
ValorTotalNotaFiscal=EnviarLoteRpsEnvio/LoteRps/ListaRps/DeclaracaoPrestacaoServico/InfDeclaracaoPrestacaoServico/Servico/ListaItensServico/ItemServico/DadosDeducao/ValorTotalNotaFiscal
PercentualADeduzir=EnviarLoteRpsEnvio/LoteRps/ListaRps/DeclaracaoPrestacaoServico/InfDeclaracaoPrestacaoServico/Servico/ListaItensServico/ItemServico/DadosDeducao/PercentualADeduzir
ValorADeduzir=EnviarLoteRpsEnvio/LoteRps/ListaRps/DeclaracaoPrestacaoServico/InfDeclaracaoPrestacaoServico/Servico/ListaItensServico/ItemServico/DadosDeducao/ValorADeduzir

;***************************************************************************************************
;Definições dos Campos: Impressão de NFSe (Impressão Nova)
;***************************************************************************************************
[PrintXml_DadosNFSe]
FILE=MappingImpressaoNFSe.txt

;***************************************************************************************************
;Definições dos Campos: Impressão de RPS (Impressão Nova)
;***************************************************************************************************
[PrintXml_DadosRPS]
FILE=MappingImpressaoRPS.txt

;***************************************************************************************************
;Campos de Configuração da Impressão Nova
;***************************************************************************************************
[PrintXml_Config]
ModoImpressao=String[4]
DiretorioTemplates=String[255]
Titulo=String[80]
BrasaoMunicipio=String[255]
LogotipoEmitente=String[255]
ArquivoMunicipios=String[255]
SecretariaResponsavel=String[255]
SubtituloNFSe=String[255]
SubtituloRPS=String[255]
DebugMode=String[5]
NomeCidade=String[80]
NomePadrao=String[20]
