;***************************************************************************************************
;        ARQUIVO DE MAPEAMENTO PARA O PADRÃO PRODABEL - MG
;***************************************************************************************************

;***************************************************************************************************
;Configuração do NFSeDataset para Envio de Lote de RPS (Proxy)
;***************************************************************************************************
[ENVIARLOTE]
XSDElementName=GerarNfseEnvio
XSDFile=nfse.xsd
XSDStartNode=GerarNfseEnvio
IgnoredXPaths=GerarNfseEnvio/LoteRps/ListaRps/Rps/Signature;GerarNfseEnvio/Signature
UseNamespacePrefixes=0
XMLHeader=
RootAttributes=

;***************************************************************************************************
;Nomes dos comandos para os respectivos datasets (para uso nos arquivos TX2)
;***************************************************************************************************
[comandos]
GerarNfseEnvio.Insert=INCLUIR
GerarNfseEnvio.Post=SALVAR
Rps.Insert=INCLUIRRPS
Rps.Post=SALVARRPS

;***************************************************************************************************
;Nomes dos Campos: Envio de Lote de RPS (Proxy)
;***************************************************************************************************
[GerarNfseEnvio]
;Dados do lote de RPS
NumeroLote=GerarNfseEnvio/LoteRps/NumeroLote
Cnpj=GerarNfseEnvio/LoteRps/Cnpj
InscricaoMunicipal=GerarNfseEnvio/LoteRps/InscricaoMunicipal
QuantidadeRps=GerarNfseEnvio/LoteRps/QuantidadeRps
Id=GerarNfseEnvio/LoteRps/@Id
versao=GerarNfseEnvio/LoteRps/@versao

;Dados do RPS
IdRps=GerarNfseEnvio/LoteRps/ListaRps/Rps/InfRps/@Id
NumeroRps=GerarNfseEnvio/LoteRps/ListaRps/Rps/InfRps/IdentificacaoRps/Numero
SerieRps=GerarNfseEnvio/LoteRps/ListaRps/Rps/InfRps/IdentificacaoRps/Serie
TipoRps=GerarNfseEnvio/LoteRps/ListaRps/Rps/InfRps/IdentificacaoRps/Tipo
DataEmissao=GerarNfseEnvio/LoteRps/ListaRps/Rps/InfRps/DataEmissao
NaturezaOperacao=GerarNfseEnvio/LoteRps/ListaRps/Rps/InfRps/NaturezaOperacao
RegimeEspecialTributacao=GerarNfseEnvio/LoteRps/ListaRps/Rps/InfRps/RegimeEspecialTributacao
OptanteSimplesNacional=GerarNfseEnvio/LoteRps/ListaRps/Rps/InfRps/OptanteSimplesNacional
IncentivadorCultural=GerarNfseEnvio/LoteRps/ListaRps/Rps/InfRps/IncentivadorCultural
Status=GerarNfseEnvio/LoteRps/ListaRps/Rps/InfRps/Status
NumeroRpsSubstituido=GerarNfseEnvio/LoteRps/ListaRps/Rps/InfRps/RpsSubstituido/Numero
SerieRpsSubstituido=GerarNfseEnvio/LoteRps/ListaRps/Rps/InfRps/RpsSubstituido/Serie
TipoRpsSubstituido=GerarNfseEnvio/LoteRps/ListaRps/Rps/InfRps/RpsSubstituido/Tipo
ValorServicos=GerarNfseEnvio/LoteRps/ListaRps/Rps/InfRps/Servico/Valores/ValorServicos
ValorDeducoes=GerarNfseEnvio/LoteRps/ListaRps/Rps/InfRps/Servico/Valores/ValorDeducoes
ValorPis=GerarNfseEnvio/LoteRps/ListaRps/Rps/InfRps/Servico/Valores/ValorPis
ValorCofins=GerarNfseEnvio/LoteRps/ListaRps/Rps/InfRps/Servico/Valores/ValorCofins
ValorInss=GerarNfseEnvio/LoteRps/ListaRps/Rps/InfRps/Servico/Valores/ValorInss
ValorIr=GerarNfseEnvio/LoteRps/ListaRps/Rps/InfRps/Servico/Valores/ValorIr
ValorCsll=GerarNfseEnvio/LoteRps/ListaRps/Rps/InfRps/Servico/Valores/ValorCsll
IssRetido=GerarNfseEnvio/LoteRps/ListaRps/Rps/InfRps/Servico/Valores/IssRetido
ValorIss=GerarNfseEnvio/LoteRps/ListaRps/Rps/InfRps/Servico/Valores/ValorIss
ValorIssRetido=GerarNfseEnvio/LoteRps/ListaRps/Rps/InfRps/Servico/Valores/ValorIssRetido
OutrasRetencoes=GerarNfseEnvio/LoteRps/ListaRps/Rps/InfRps/Servico/Valores/OutrasRetencoes
BaseCalculo=GerarNfseEnvio/LoteRps/ListaRps/Rps/InfRps/Servico/Valores/BaseCalculo
Aliquota=GerarNfseEnvio/LoteRps/ListaRps/Rps/InfRps/Servico/Valores/Aliquota
ValorLiquidoNfse=GerarNfseEnvio/LoteRps/ListaRps/Rps/InfRps/Servico/Valores/ValorLiquidoNfse
DescontoIncondicionado=GerarNfseEnvio/LoteRps/ListaRps/Rps/InfRps/Servico/Valores/DescontoIncondicionado
DescontoCondicionado=GerarNfseEnvio/LoteRps/ListaRps/Rps/InfRps/Servico/Valores/DescontoCondicionado
ItemListaServico=GerarNfseEnvio/LoteRps/ListaRps/Rps/InfRps/Servico/ItemListaServico
CodigoCnae=GerarNfseEnvio/LoteRps/ListaRps/Rps/InfRps/Servico/CodigoCnae
CodigoTributacaoMunicipio=GerarNfseEnvio/LoteRps/ListaRps/Rps/InfRps/Servico/CodigoTributacaoMunicipio
Discriminacao=GerarNfseEnvio/LoteRps/ListaRps/Rps/InfRps/Servico/Discriminacao
CodigoMunicipio=GerarNfseEnvio/LoteRps/ListaRps/Rps/InfRps/Servico/CodigoMunicipio
CnpjPrestador=GerarNfseEnvio/LoteRps/ListaRps/Rps/InfRps/Prestador/Cnpj
InscricaoMunicipalPrestador=GerarNfseEnvio/LoteRps/ListaRps/Rps/InfRps/Prestador/InscricaoMunicipal
CpfTomador=GerarNfseEnvio/LoteRps/ListaRps/Rps/InfRps/Tomador/IdentificacaoTomador/CpfCnpj/Cpf
CnpjTomador=GerarNfseEnvio/LoteRps/ListaRps/Rps/InfRps/Tomador/IdentificacaoTomador/CpfCnpj/Cnpj
InscricaoMunicipalTomador=GerarNfseEnvio/LoteRps/ListaRps/Rps/InfRps/Tomador/IdentificacaoTomador/InscricaoMunicipal
RazaoSocialTomador=GerarNfseEnvio/LoteRps/ListaRps/Rps/InfRps/Tomador/RazaoSocial
EnderecoTomador=GerarNfseEnvio/LoteRps/ListaRps/Rps/InfRps/Tomador/Endereco/Endereco
NumeroTomador=GerarNfseEnvio/LoteRps/ListaRps/Rps/InfRps/Tomador/Endereco/Numero
ComplementoTomador=GerarNfseEnvio/LoteRps/ListaRps/Rps/InfRps/Tomador/Endereco/Complemento
BairroTomador=GerarNfseEnvio/LoteRps/ListaRps/Rps/InfRps/Tomador/Endereco/Bairro
CodigoMunicipioTomador=GerarNfseEnvio/LoteRps/ListaRps/Rps/InfRps/Tomador/Endereco/CodigoMunicipio
UfTomador=GerarNfseEnvio/LoteRps/ListaRps/Rps/InfRps/Tomador/Endereco/Uf
CepTomador=GerarNfseEnvio/LoteRps/ListaRps/Rps/InfRps/Tomador/Endereco/Cep
TelefoneTomador=GerarNfseEnvio/LoteRps/ListaRps/Rps/InfRps/Tomador/Contato/Telefone
EmailTomador=GerarNfseEnvio/LoteRps/ListaRps/Rps/InfRps/Tomador/Contato/Email
CpfIntermediario=GerarNfseEnvio/LoteRps/ListaRps/Rps/InfRps/IntermediarioServico/IdentificacaoIntermediario/CpfCnpj/Cpf
CnpjIntermediario=GerarNfseEnvio/LoteRps/ListaRps/Rps/InfRps/IntermediarioServico/IdentificacaoIntermediario/CpfCnpj/Cnpj
InscricaoMunicipalIntermediario=GerarNfseEnvio/LoteRps/ListaRps/Rps/InfRps/IntermediarioServico/InscricaoMunicipal                                
RazaoSocialIntermediario=GerarNfseEnvio/LoteRps/ListaRps/Rps/InfRps/IntermediarioServico/RazaoSocial
CodigoObra=GerarNfseEnvio/LoteRps/ListaRps/Rps/InfRps/ConstrucaoCivil/CodigoObra
Art=GerarNfseEnvio/LoteRps/ListaRps/Rps/InfRps/ConstrucaoCivil/Art

;***************************************************************************************************
;Definições dos Campos: Impressão de NFSe (Impressão Nova)
;***************************************************************************************************
[PrintXml_DadosNFSe]
FILE=MappingImpressao.txt

;***************************************************************************************************
;Definições dos Campos: Impressão de RPS (Impressão Nova)
;***************************************************************************************************
[PrintXml_DadosRPS]
FILE=MappingImpressao.txt

;***************************************************************************************************
;Campos de Configuração da Impressão Nova
;***************************************************************************************************
[PrintXml_Config]
ModoImpressao=String[4]
DiretorioTemplates=String[255]
Titulo=String[80]
BrasaoMunicipio=String[255]
LogotipoEmitente=String[255]
ArquivoMunicipios=String[255]
DebugMode=String[5]
